Close,DownTicks,DownVolume,High,Low,Open,Status,TimeStamp,TotalTicks,TotalVolume,UnchangedTicks,UnchangedVolume,UpTicks,UpVolume,OpenInterest,DateTime
4348.0,636,921,4354.25,4345.0,4345.25,13,/Date(1643238060000)/,1298,1959,0,0,662,1038,0,2022-01-26 18:01:00
4350.75,156,241,4351.0,4347.75,4348.0,13,/Date(1643238120000)/,351,530,0,0,195,289,0,2022-01-26 18:02:00
4356.25,487,701,4359.75,4350.5,4350.5,13,/Date(1643238180000)/,1299,1916,0,0,812,1215,0,2022-01-26 18:03:00
4355.0,154,193,4357.0,4354.25,4356.25,13,/Date(1643238240000)/,370,519,0,0,216,326,0,2022-01-26 18:04:00
4353.5,274,394,4355.0,4351.0,4354.75,13,/Date(1643238300000)/,431,567,0,0,157,173,0,2022-01-26 18:05:00
4354.25,154,233,4354.75,4351.5,4353.75,13,/Date(1643238360000)/,319,437,0,0,165,204,0,2022-01-26 18:06:00
4356.0,157,215,4356.25,4353.75,4354.0,13,/Date(1643238420000)/,364,461,0,0,207,246,0,2022-01-26 18:07:00
4357.5,78,86,4357.75,4355.75,4356.0,13,/Date(1643238480000)/,212,241,0,0,134,155,0,2022-01-26 18:08:00
4362.0,199,232,4362.0,4356.25,4357.25,13,/Date(1643238540000)/,547,829,0,0,348,597,0,2022-01-26 18:09:00
4364.0,271,406,4364.0,4360.0,4362.0,13,/Date(1643238600000)/,572,777,0,0,301,371,0,2022-01-26 18:10:00
4360.75,412,538,4364.75,4359.75,4364.25,13,/Date(1643238660000)/,682,889,0,0,270,351,0,2022-01-26 18:11:00
4361.25,213,240,4362.5,4359.75,4360.5,13,/Date(1643238720000)/,373,461,0,0,160,221,0,2022-01-26 18:12:00
4360.75,192,230,4361.75,4359.25,4361.0,13,/Date(1643238780000)/,364,432,0,0,172,202,0,2022-01-26 18:13:00
4362.0,180,268,4363.0,4360.75,4360.75,13,/Date(1643238840000)/,413,560,0,0,233,292,0,2022-01-26 18:14:00
4362.75,90,102,4363.0,4360.75,4362.25,13,/Date(1643238900000)/,228,270,0,0,138,168,0,2022-01-26 18:15:00
4363.75,156,175,4365.0,4361.25,4362.75,13,/Date(1643238960000)/,457,549,0,0,301,374,0,2022-01-26 18:16:00
4361.25,167,190,4363.75,4361.25,4363.5,13,/Date(1643239020000)/,270,301,0,0,103,111,0,2022-01-26 18:17:00
4359.75,258,297,4361.5,4359.25,4361.25,13,/Date(1643239080000)/,427,520,0,0,169,223,0,2022-01-26 18:18:00
4357.5,311,359,4359.75,4356.75,4359.75,13,/Date(1643239140000)/,457,526,0,0,146,167,0,2022-01-26 18:19:00
4358.25,269,348,4359.25,4356.0,4357.5,13,/Date(1643239200000)/,475,612,0,0,206,264,0,2022-01-26 18:20:00
4361.0,223,236,4362.0,4358.0,4358.5,13,/Date(1643239260000)/,574,632,0,0,351,396,0,2022-01-26 18:21:00
4361.25,87,115,4362.0,4361.0,4361.0,13,/Date(1643239320000)/,202,239,0,0,115,124,0,2022-01-26 18:22:00
4360.75,95,101,4362.5,4360.0,4361.25,13,/Date(1643239380000)/,194,212,0,0,99,111,0,2022-01-26 18:23:00
4361.5,121,125,4363.0,4360.25,4360.5,13,/Date(1643239440000)/,282,305,0,0,161,180,0,2022-01-26 18:24:00
4360.0,94,107,4362.25,4360.0,4361.5,13,/Date(1643239500000)/,155,177,0,0,61,70,0,2022-01-26 18:25:00
4360.0,77,88,4361.0,4359.75,4360.0,13,/Date(1643239560000)/,170,200,0,0,93,112,0,2022-01-26 18:26:00
4361.5,96,101,4364.0,4359.75,4359.75,13,/Date(1643239620000)/,295,384,0,0,199,283,0,2022-01-26 18:27:00
4359.0,130,163,4361.5,4359.0,4361.5,13,/Date(1643239680000)/,217,265,0,0,87,102,0,2022-01-26 18:28:00
4358.25,91,105,4359.25,4357.5,4359.0,13,/Date(1643239740000)/,175,194,0,0,84,89,0,2022-01-26 18:29:00
4361.75,84,85,4362.25,4358.25,4358.25,13,/Date(1643239800000)/,226,239,0,0,142,154,0,2022-01-26 18:30:00
4365.25,253,282,4366.5,4362.0,4362.0,13,/Date(1643239860000)/,719,862,0,0,466,580,0,2022-01-26 18:31:00
4364.5,220,275,4367.0,4364.0,4365.25,13,/Date(1643239920000)/,442,533,0,0,222,258,0,2022-01-26 18:32:00
4365.75,150,161,4366.25,4363.0,4364.25,13,/Date(1643239980000)/,396,450,0,0,246,289,0,2022-01-26 18:33:00
4366.5,105,108,4366.5,4364.5,4365.75,13,/Date(1643240040000)/,199,206,0,0,94,98,0,2022-01-26 18:34:00
4366.25,195,266,4368.0,4366.25,4366.25,13,/Date(1643240100000)/,434,618,0,0,239,352,0,2022-01-26 18:35:00
4366.5,158,169,4367.5,4365.5,4366.25,13,/Date(1643240160000)/,382,419,0,0,224,250,0,2022-01-26 18:36:00
4367.25,28,30,4367.25,4365.75,4366.25,13,/Date(1643240220000)/,107,137,0,0,79,107,0,2022-01-26 18:37:00
4365.5,177,190,4367.25,4364.75,4367.0,13,/Date(1643240280000)/,296,364,0,0,119,174,0,2022-01-26 18:38:00
4364.5,158,166,4365.75,4363.5,4365.5,13,/Date(1643240340000)/,274,290,0,0,116,124,0,2022-01-26 18:39:00
4364.0,73,78,4365.0,4363.5,4364.75,13,/Date(1643240400000)/,161,172,0,0,88,94,0,2022-01-26 18:40:00
4363.25,141,146,4364.75,4362.75,4364.0,13,/Date(1643240460000)/,232,246,0,0,91,100,0,2022-01-26 18:41:00
4363.75,141,152,4364.25,4362.0,4363.25,13,/Date(1643240520000)/,407,429,0,0,266,277,0,2022-01-26 18:42:00
4365.0,73,77,4365.0,4363.0,4363.75,13,/Date(1643240580000)/,175,191,0,0,102,114,0,2022-01-26 18:43:00
4364.5,131,148,4365.25,4363.5,4365.0,13,/Date(1643240640000)/,303,362,0,0,172,214,0,2022-01-26 18:44:00
4364.0,93,118,4365.0,4363.25,4364.5,13,/Date(1643240700000)/,176,221,0,0,83,103,0,2022-01-26 18:45:00
4365.0,86,87,4366.25,4364.0,4364.0,13,/Date(1643240760000)/,292,390,0,0,206,303,0,2022-01-26 18:46:00
4366.25,71,73,4366.5,4364.75,4364.75,13,/Date(1643240820000)/,163,175,0,0,92,102,0,2022-01-26 18:47:00
4364.75,112,120,4366.75,4363.75,4366.25,13,/Date(1643240880000)/,198,212,0,0,86,92,0,2022-01-26 18:48:00
4365.5,81,91,4366.75,4364.75,4364.75,13,/Date(1643240940000)/,160,178,0,0,79,87,0,2022-01-26 18:49:00
4364.75,80,83,4366.25,4364.75,4365.25,13,/Date(1643241000000)/,142,147,0,0,62,64,0,2022-01-26 18:50:00
4362.5,138,174,4365.0,4362.25,4364.75,13,/Date(1643241060000)/,183,223,0,0,45,49,0,2022-01-26 18:51:00
4363.25,49,55,4364.0,4362.0,4362.0,13,/Date(1643241120000)/,175,195,0,0,126,140,0,2022-01-26 18:52:00
4364.75,88,113,4365.0,4362.5,4363.5,13,/Date(1643241180000)/,192,221,0,0,104,108,0,2022-01-26 18:53:00
4364.25,44,56,4365.25,4363.5,4364.75,13,/Date(1643241240000)/,97,109,0,0,53,53,0,2022-01-26 18:54:00
4363.0,43,52,4364.25,4363.0,4364.0,13,/Date(1643241300000)/,64,74,0,0,21,22,0,2022-01-26 18:55:00
4364.25,78,82,4364.75,4362.25,4362.75,13,/Date(1643241360000)/,177,199,0,0,99,117,0,2022-01-26 18:56:00
4364.5,75,81,4365.0,4363.25,4364.5,13,/Date(1643241420000)/,118,129,0,0,43,48,0,2022-01-26 18:57:00
4364.75,38,39,4364.75,4363.75,4364.75,13,/Date(1643241480000)/,80,99,0,0,42,60,0,2022-01-26 18:58:00
4364.5,122,127,4366.25,4364.5,4364.75,13,/Date(1643241540000)/,305,355,0,0,183,228,0,2022-01-26 18:59:00
4366.0,33,37,4366.25,4364.0,4364.5,13,/Date(1643241600000)/,110,134,0,0,77,97,0,2022-01-26 19:00:00
4363.5,371,467,4367.25,4360.25,4366.0,13,/Date(1643241660000)/,680,801,0,0,309,334,0,2022-01-26 19:01:00
4361.0,156,178,4363.75,4361.0,4363.75,13,/Date(1643241720000)/,271,320,0,0,115,142,0,2022-01-26 19:02:00
4363.0,87,137,4363.0,4361.25,4361.25,13,/Date(1643241780000)/,175,233,0,0,88,96,0,2022-01-26 19:03:00
4364.25,40,43,4364.25,4362.0,4363.0,13,/Date(1643241840000)/,133,144,0,0,93,101,0,2022-01-26 19:04:00
4363.25,85,87,4364.5,4362.75,4364.25,13,/Date(1643241900000)/,187,207,0,0,102,120,0,2022-01-26 19:05:00
4362.0,135,170,4364.0,4360.25,4363.25,13,/Date(1643241960000)/,259,313,0,0,124,143,0,2022-01-26 19:06:00
4360.0,117,124,4362.0,4360.0,4361.75,13,/Date(1643242020000)/,183,202,0,0,66,78,0,2022-01-26 19:07:00
4358.0,216,303,4360.5,4357.25,4360.0,13,/Date(1643242080000)/,368,455,0,0,152,152,0,2022-01-26 19:08:00
4358.5,266,295,4358.75,4356.5,4357.75,13,/Date(1643242140000)/,494,543,0,0,228,248,0,2022-01-26 19:09:00
4357.75,127,135,4358.75,4357.0,4358.5,13,/Date(1643242200000)/,255,274,0,0,128,139,0,2022-01-26 19:10:00
4357.75,196,207,4358.25,4356.0,4357.75,13,/Date(1643242260000)/,319,339,0,0,123,132,0,2022-01-26 19:11:00
4355.25,192,212,4357.75,4355.0,4357.75,13,/Date(1643242320000)/,300,335,0,0,108,123,0,2022-01-26 19:12:00
4354.0,212,251,4357.5,4354.0,4355.5,13,/Date(1643242380000)/,367,426,0,0,155,175,0,2022-01-26 19:13:00
4354.5,131,147,4355.25,4353.0,4354.25,13,/Date(1643242440000)/,257,287,0,0,126,140,0,2022-01-26 19:14:00
4354.25,172,200,4354.25,4353.0,4354.25,13,/Date(1643242500000)/,325,385,0,0,153,185,0,2022-01-26 19:15:00
4352.0,205,230,4354.25,4351.75,4354.0,13,/Date(1643242560000)/,314,347,0,0,109,117,0,2022-01-26 19:16:00
4351.75,216,233,4354.0,4351.25,4352.0,13,/Date(1643242620000)/,413,450,0,0,197,217,0,2022-01-26 19:17:00
4353.25,200,222,4353.5,4350.75,4352.0,13,/Date(1643242680000)/,417,451,0,0,217,229,0,2022-01-26 19:18:00
4351.25,135,164,4353.25,4351.0,4353.25,13,/Date(1643242740000)/,241,280,0,0,106,116,0,2022-01-26 19:19:00
4350.25,293,378,4351.25,4349.25,4351.0,13,/Date(1643242800000)/,449,569,0,0,156,191,0,2022-01-26 19:20:00
4350.0,319,375,4350.25,4347.25,4350.25,13,/Date(1643242860000)/,602,676,0,0,283,301,0,2022-01-26 19:21:00
4347.5,165,198,4350.25,4347.0,4350.25,13,/Date(1643242920000)/,252,301,0,0,87,103,0,2022-01-26 19:22:00
4348.75,144,147,4350.5,4347.0,4347.5,13,/Date(1643242980000)/,350,402,0,0,206,255,0,2022-01-26 19:23:00
4352.5,95,98,4352.5,4348.75,4348.75,13,/Date(1643243040000)/,290,319,0,0,195,221,0,2022-01-26 19:24:00
4355.0,118,130,4355.5,4352.25,4352.5,13,/Date(1643243100000)/,344,391,0,0,226,261,0,2022-01-26 19:25:00
4356.0,98,108,4356.25,4354.5,4354.75,13,/Date(1643243160000)/,211,228,0,0,113,120,0,2022-01-26 19:26:00
4355.25,89,114,4356.25,4354.75,4356.25,13,/Date(1643243220000)/,167,196,0,0,78,82,0,2022-01-26 19:27:00
4353.25,142,156,4355.25,4353.25,4355.25,13,/Date(1643243280000)/,277,299,0,0,135,143,0,2022-01-26 19:28:00
4350.75,204,225,4353.75,4350.25,4353.25,13,/Date(1643243340000)/,355,430,0,0,151,205,0,2022-01-26 19:29:00
4349.75,127,143,4351.5,4348.5,4350.5,13,/Date(1643243400000)/,294,330,0,0,167,187,0,2022-01-26 19:30:00
4348.25,157,171,4350.75,4347.25,4350.0,13,/Date(1643243460000)/,276,299,0,0,119,128,0,2022-01-26 19:31:00
4348.5,206,215,4349.0,4346.0,4348.5,13,/Date(1643243520000)/,360,405,0,0,154,190,0,2022-01-26 19:32:00
4348.0,76,83,4349.0,4347.5,4348.0,13,/Date(1643243580000)/,154,166,0,0,78,83,0,2022-01-26 19:33:00
4349.0,188,213,4349.0,4345.0,4348.25,13,/Date(1643243640000)/,389,455,0,0,201,242,0,2022-01-26 19:34:00
4350.25,152,160,4350.25,4348.0,4349.25,13,/Date(1643243700000)/,313,369,0,0,161,209,0,2022-01-26 19:35:00
4349.0,127,133,4350.5,4347.0,4350.5,13,/Date(1643243760000)/,203,213,0,0,76,80,0,2022-01-26 19:36:00
4350.0,92,95,4350.25,4346.75,4348.75,13,/Date(1643243820000)/,222,257,0,0,130,162,0,2022-01-26 19:37:00
4349.5,77,79,4350.75,4349.5,4349.75,13,/Date(1643243880000)/,150,159,0,0,73,80,0,2022-01-26 19:38:00
4347.25,131,150,4350.0,4347.25,4349.5,13,/Date(1643243940000)/,221,249,0,0,90,99,0,2022-01-26 19:39:00
4348.25,90,102,4348.25,4346.75,4347.25,13,/Date(1643244000000)/,205,252,0,0,115,150,0,2022-01-26 19:40:00
4344.0,433,495,4350.0,4342.0,4348.0,13,/Date(1643244060000)/,712,804,0,0,279,309,0,2022-01-26 19:41:00
4346.5,82,86,4346.5,4344.0,4344.0,13,/Date(1643244120000)/,222,242,0,0,140,156,0,2022-01-26 19:42:00
4347.25,108,112,4348.0,4344.5,4346.5,13,/Date(1643244180000)/,268,279,0,0,160,167,0,2022-01-26 19:43:00
4347.25,72,76,4348.25,4347.0,4347.5,13,/Date(1643244240000)/,153,173,0,0,81,97,0,2022-01-26 19:44:00
4346.25,76,80,4347.25,4345.75,4346.75,13,/Date(1643244300000)/,122,129,0,0,46,49,0,2022-01-26 19:45:00
4344.5,203,214,4346.25,4344.0,4346.25,13,/Date(1643244360000)/,340,515,0,0,137,301,0,2022-01-26 19:46:00
4347.5,54,60,4347.5,4344.0,4344.75,13,/Date(1643244420000)/,200,219,0,0,146,159,0,2022-01-26 19:47:00
4347.0,81,82,4348.25,4346.0,4347.5,13,/Date(1643244480000)/,175,182,0,0,94,100,0,2022-01-26 19:48:00
4346.0,69,96,4346.75,4345.5,4346.75,13,/Date(1643244540000)/,117,153,0,0,48,57,0,2022-01-26 19:49:00
4344.75,87,94,4347.0,4343.75,4346.0,13,/Date(1643244600000)/,121,133,0,0,34,39,0,2022-01-26 19:50:00
4346.5,29,34,4346.75,4344.5,4345.25,13,/Date(1643244660000)/,91,110,0,0,62,76,0,2022-01-26 19:51:00
4348.75,112,144,4349.5,4346.0,4346.5,13,/Date(1643244720000)/,290,372,0,0,178,228,0,2022-01-26 19:52:00
4347.25,48,60,4348.75,4347.25,4348.75,13,/Date(1643244780000)/,79,95,0,0,31,35,0,2022-01-26 19:53:00
4345.5,114,130,4347.25,4344.5,4347.0,13,/Date(1643244840000)/,156,175,0,0,42,45,0,2022-01-26 19:54:00
4340.25,437,663,4345.75,4339.25,4345.25,13,/Date(1643244900000)/,709,982,0,0,272,319,0,2022-01-26 19:55:00
4341.25,321,368,4342.0,4338.25,4340.0,13,/Date(1643244960000)/,596,681,0,0,275,313,0,2022-01-26 19:56:00
4338.5,184,204,4341.75,4338.25,4341.0,13,/Date(1643245020000)/,359,398,0,0,175,194,0,2022-01-26 19:57:00
4338.75,180,200,4339.75,4337.5,4338.25,13,/Date(1643245080000)/,371,400,0,0,191,200,0,2022-01-26 19:58:00
4337.0,307,344,4339.0,4336.0,4338.5,13,/Date(1643245140000)/,559,613,0,0,252,269,0,2022-01-26 19:59:00
4334.5,436,519,4336.75,4333.5,4336.75,13,/Date(1643245200000)/,717,829,0,0,281,310,0,2022-01-26 20:00:00
4335.75,277,335,4337.0,4332.5,4334.5,13,/Date(1643245260000)/,639,733,0,0,362,398,0,2022-01-26 20:01:00
4329.75,555,711,4336.5,4329.0,4336.0,13,/Date(1643245320000)/,813,996,0,0,258,285,0,2022-01-26 20:02:00
4330.0,322,371,4332.0,4329.25,4330.0,13,/Date(1643245380000)/,571,640,0,0,249,269,0,2022-01-26 20:03:00
4329.5,294,330,4331.0,4326.0,4330.25,13,/Date(1643245440000)/,561,614,0,0,267,284,0,2022-01-26 20:04:00
4326.5,397,506,4329.0,4324.0,4329.0,13,/Date(1643245500000)/,680,813,0,0,283,307,0,2022-01-26 20:05:00
4323.75,292,349,4328.5,4323.75,4326.5,13,/Date(1643245560000)/,469,528,0,0,177,179,0,2022-01-26 20:06:00
4322.25,430,521,4324.75,4320.0,4324.25,13,/Date(1643245620000)/,887,1063,0,0,457,542,0,2022-01-26 20:07:00
4317.5,749,922,4322.5,4314.5,4322.25,13,/Date(1643245680000)/,1313,1552,0,0,564,630,0,2022-01-26 20:08:00
4316.75,382,643,4319.25,4314.5,4317.5,13,/Date(1643245740000)/,755,1045,0,0,373,402,0,2022-01-26 20:09:00
4317.5,252,280,4319.5,4316.25,4316.75,13,/Date(1643245800000)/,590,650,0,0,338,370,0,2022-01-26 20:10:00
4321.0,240,274,4322.0,4316.75,4317.0,13,/Date(1643245860000)/,560,688,0,0,320,414,0,2022-01-26 20:11:00
4323.5,314,391,4325.5,4321.25,4321.5,13,/Date(1643245920000)/,813,972,0,0,499,581,0,2022-01-26 20:12:00
4318.75,321,358,4323.25,4318.25,4323.25,13,/Date(1643245980000)/,568,615,0,0,247,257,0,2022-01-26 20:13:00
4319.75,195,220,4320.75,4316.75,4318.5,13,/Date(1643246040000)/,421,509,0,0,226,289,0,2022-01-26 20:14:00
4319.0,145,173,4319.75,4317.5,4319.5,13,/Date(1643246100000)/,309,368,0,0,164,195,0,2022-01-26 20:15:00
4317.25,312,371,4322.0,4316.75,4319.5,13,/Date(1643246160000)/,580,703,0,0,268,332,0,2022-01-26 20:16:00
4312.75,982,1383,4317.5,4311.5,4317.25,13,/Date(1643246220000)/,1588,2039,0,0,606,656,0,2022-01-26 20:17:00
4310.0,803,1081,4314.25,4307.5,4312.75,13,/Date(1643246280000)/,1325,1652,0,0,522,571,0,2022-01-26 20:18:00
4309.5,949,1168,4310.0,4302.25,4309.75,13,/Date(1643246340000)/,1734,2099,0,0,785,931,0,2022-01-26 20:19:00
4308.25,375,420,4311.25,4305.75,4309.25,13,/Date(1643246400000)/,712,787,0,0,337,367,0,2022-01-26 20:20:00
4306.75,394,444,4310.75,4305.5,4308.25,13,/Date(1643246460000)/,700,764,0,0,306,320,0,2022-01-26 20:21:00
4306.5,346,436,4310.25,4305.75,4306.75,13,/Date(1643246520000)/,700,852,0,0,354,416,0,2022-01-26 20:22:00
4303.5,434,499,4306.5,4303.0,4306.5,13,/Date(1643246580000)/,755,877,0,0,321,378,0,2022-01-26 20:23:00
4307.25,274,306,4308.75,4303.75,4303.75,13,/Date(1643246640000)/,652,831,0,0,378,525,0,2022-01-26 20:24:00
4310.75,243,257,4311.5,4306.25,4307.0,13,/Date(1643246700000)/,547,582,0,0,304,325,0,2022-01-26 20:25:00
4312.5,157,166,4312.75,4309.0,4310.75,13,/Date(1643246760000)/,424,492,0,0,267,326,0,2022-01-26 20:26:00
4309.5,264,296,4312.75,4308.5,4312.25,13,/Date(1643246820000)/,443,490,0,0,179,194,0,2022-01-26 20:27:00
4313.5,116,140,4314.0,4309.25,4309.5,13,/Date(1643246880000)/,360,406,0,0,244,266,0,2022-01-26 20:28:00
4313.25,188,234,4315.0,4312.5,4313.5,13,/Date(1643246940000)/,412,481,0,0,224,247,0,2022-01-26 20:29:00
4310.0,220,255,4314.25,4309.5,4313.5,13,/Date(1643247000000)/,412,460,0,0,192,205,0,2022-01-26 20:30:00
4307.75,396,424,4310.5,4306.0,4310.25,13,/Date(1643247060000)/,679,727,0,0,283,303,0,2022-01-26 20:31:00
4310.5,257,279,4314.0,4307.75,4307.75,13,/Date(1643247120000)/,555,604,0,0,298,325,0,2022-01-26 20:32:00
4312.5,297,325,4313.75,4306.75,4310.5,13,/Date(1643247180000)/,724,815,0,0,427,490,0,2022-01-26 20:33:00
4313.0,166,197,4314.75,4312.0,4312.5,13,/Date(1643247240000)/,382,443,0,0,216,246,0,2022-01-26 20:34:00
4313.75,106,115,4314.5,4312.0,4312.5,13,/Date(1643247300000)/,251,271,0,0,145,156,0,2022-01-26 20:35:00
4313.75,268,302,4316.75,4313.25,4314.0,13,/Date(1643247360000)/,592,729,0,0,324,427,0,2022-01-26 20:36:00
4313.0,197,228,4314.5,4312.0,4313.75,13,/Date(1643247420000)/,365,415,0,0,168,187,0,2022-01-26 20:37:00
4313.75,78,79,4314.25,4312.0,4312.75,13,/Date(1643247480000)/,155,168,0,0,77,89,0,2022-01-26 20:38:00
4310.0,247,283,4314.0,4309.5,4313.75,13,/Date(1643247540000)/,371,416,0,0,124,133,0,2022-01-26 20:39:00
4309.0,152,165,4313.5,4308.5,4310.25,13,/Date(1643247600000)/,276,294,0,0,124,129,0,2022-01-26 20:40:00
4309.25,257,285,4311.0,4306.5,4309.0,13,/Date(1643247660000)/,518,596,0,0,261,311,0,2022-01-26 20:41:00
4311.0,267,308,4313.0,4305.75,4309.5,13,/Date(1643247720000)/,477,525,0,0,210,217,0,2022-01-26 20:42:00
4309.0,243,278,4312.25,4308.5,4311.25,13,/Date(1643247780000)/,418,474,0,0,175,196,0,2022-01-26 20:43:00
4309.25,49,64,4311.25,4309.0,4309.25,13,/Date(1643247840000)/,124,139,0,0,75,75,0,2022-01-26 20:44:00
4308.5,119,134,4310.5,4308.0,4309.0,13,/Date(1643247900000)/,208,226,0,0,89,92,0,2022-01-26 20:45:00
4305.0,308,387,4309.25,4304.5,4308.75,13,/Date(1643247960000)/,564,660,0,0,256,273,0,2022-01-26 20:46:00
4307.5,217,257,4308.0,4303.5,4305.0,13,/Date(1643248020000)/,457,513,0,0,240,256,0,2022-01-26 20:47:00
4306.75,216,253,4309.5,4305.0,4307.25,13,/Date(1643248080000)/,484,546,0,0,268,293,0,2022-01-26 20:48:00
4304.25,328,367,4308.5,4303.5,4306.5,13,/Date(1643248140000)/,525,637,0,0,197,270,0,2022-01-26 20:49:00
4304.75,192,242,4305.75,4303.25,4304.25,13,/Date(1643248200000)/,414,547,0,0,222,305,0,2022-01-26 20:50:00
4302.0,404,469,4306.0,4302.0,4305.0,13,/Date(1643248260000)/,667,770,0,0,263,301,0,2022-01-26 20:51:00
4306.25,414,477,4306.5,4301.0,4301.75,13,/Date(1643248320000)/,1000,1141,0,0,586,664,0,2022-01-26 20:52:00
4307.0,263,292,4308.25,4305.5,4306.0,13,/Date(1643248380000)/,514,587,0,0,251,295,0,2022-01-26 20:53:00
4303.75,243,261,4307.75,4303.75,4307.0,13,/Date(1643248440000)/,414,445,0,0,171,184,0,2022-01-26 20:54:00
4302.5,381,470,4305.0,4301.0,4304.0,13,/Date(1643248500000)/,695,823,0,0,314,353,0,2022-01-26 20:55:00
4298.0,722,1012,4303.0,4297.5,4302.5,13,/Date(1643248560000)/,1168,1507,0,0,446,495,0,2022-01-26 20:56:00
4295.75,528,615,4300.0,4295.25,4298.25,13,/Date(1643248620000)/,907,1014,0,0,379,399,0,2022-01-26 20:57:00
4299.0,365,434,4299.25,4294.75,4296.0,13,/Date(1643248680000)/,928,1071,0,0,563,637,0,2022-01-26 20:58:00
4293.75,613,862,4300.5,4292.75,4299.25,13,/Date(1643248740000)/,1035,1357,0,0,422,495,0,2022-01-26 20:59:00
4296.75,306,339,4297.5,4293.75,4293.75,13,/Date(1643248800000)/,697,786,0,0,391,447,0,2022-01-26 21:00:00
4289.0,809,972,4297.0,4288.0,4296.75,13,/Date(1643248860000)/,1304,1496,0,0,495,524,0,2022-01-26 21:01:00
4286.75,495,598,4292.0,4285.5,4288.75,13,/Date(1643248920000)/,952,1122,0,0,457,524,0,2022-01-26 21:02:00
4286.25,341,395,4290.25,4286.0,4286.75,13,/Date(1643248980000)/,709,821,0,0,368,426,0,2022-01-26 21:03:00
4289.0,224,265,4289.75,4286.0,4286.5,13,/Date(1643249040000)/,508,573,0,0,284,308,0,2022-01-26 21:04:00
4289.0,227,277,4291.0,4287.25,4289.25,13,/Date(1643249100000)/,461,556,0,0,234,279,0,2022-01-26 21:05:00
4288.75,310,347,4291.5,4287.5,4289.0,13,/Date(1643249160000)/,571,662,0,0,261,315,0,2022-01-26 21:06:00
4283.0,559,745,4288.75,4281.5,4288.75,13,/Date(1643249220000)/,871,1087,0,0,312,342,0,2022-01-26 21:07:00
4282.75,353,470,4284.0,4281.0,4282.75,13,/Date(1643249280000)/,649,833,0,0,296,363,0,2022-01-26 21:08:00
4284.75,347,500,4285.5,4281.0,4283.25,13,/Date(1643249340000)/,940,1211,0,0,593,711,0,2022-01-26 21:09:00
4281.0,315,438,4285.0,4281.0,4284.75,13,/Date(1643249400000)/,479,615,0,0,164,177,0,2022-01-26 21:10:00
4282.5,165,189,4284.0,4281.0,4281.25,13,/Date(1643249460000)/,437,528,0,0,272,339,0,2022-01-26 21:11:00
4284.5,181,204,4285.0,4282.25,4282.25,13,/Date(1643249520000)/,425,517,0,0,244,313,0,2022-01-26 21:12:00
4283.5,334,401,4286.25,4283.5,4284.5,13,/Date(1643249580000)/,634,734,0,0,300,333,0,2022-01-26 21:13:00
4282.25,302,343,4284.5,4281.5,4283.75,13,/Date(1643249640000)/,612,677,0,0,310,334,0,2022-01-26 21:14:00
4282.75,175,195,4283.0,4281.25,4282.25,13,/Date(1643249700000)/,333,398,0,0,158,203,0,2022-01-26 21:15:00
4284.25,192,250,4284.5,4281.5,4282.5,13,/Date(1643249760000)/,384,454,0,0,192,204,0,2022-01-26 21:16:00
4282.0,220,282,4284.25,4281.0,4284.25,13,/Date(1643249820000)/,326,405,0,0,106,123,0,2022-01-26 21:17:00
4281.75,197,218,4283.25,4281.25,4281.75,13,/Date(1643249880000)/,384,444,0,0,187,226,0,2022-01-26 21:18:00
4283.0,71,76,4283.75,4281.75,4281.75,13,/Date(1643249940000)/,164,178,0,0,93,102,0,2022-01-26 21:19:00
4281.5,158,212,4283.5,4281.25,4283.0,13,/Date(1643250000000)/,265,324,0,0,107,112,0,2022-01-26 21:20:00
4282.75,155,162,4283.5,4281.5,4281.75,13,/Date(1643250060000)/,373,422,0,0,218,260,0,2022-01-26 21:21:00
4282.25,129,146,4283.25,4281.25,4282.75,13,/Date(1643250120000)/,277,299,0,0,148,153,0,2022-01-26 21:22:00
4282.5,275,621,4282.75,4281.0,4282.25,13,/Date(1643250180000)/,493,869,0,0,218,248,0,2022-01-26 21:23:00
4283.5,314,336,4285.0,4282.5,4282.75,13,/Date(1643250240000)/,644,710,0,0,330,374,0,2022-01-26 21:24:00
4284.5,94,95,4284.5,4282.25,4283.5,13,/Date(1643250300000)/,242,247,0,0,148,152,0,2022-01-26 21:25:00
4282.0,355,590,4285.75,4281.0,4284.25,13,/Date(1643250360000)/,616,931,0,0,261,341,0,2022-01-26 21:26:00
4279.75,578,815,4283.0,4278.25,4282.25,13,/Date(1643250420000)/,886,1150,0,0,308,335,0,2022-01-26 21:27:00
4278.25,540,710,4280.0,4276.75,4279.5,13,/Date(1643250480000)/,1017,1264,0,0,477,554,0,2022-01-26 21:28:00
4278.0,177,201,4279.0,4277.5,4278.25,13,/Date(1643250540000)/,311,359,0,0,134,158,0,2022-01-26 21:29:00
4279.75,178,183,4280.0,4277.75,4278.0,13,/Date(1643250600000)/,397,446,0,0,219,263,0,2022-01-26 21:30:00
4280.75,274,376,4282.5,4278.75,4279.5,13,/Date(1643250660000)/,608,787,0,0,334,411,0,2022-01-26 21:31:00
4279.75,298,386,4280.75,4278.75,4280.75,13,/Date(1643250720000)/,470,584,0,0,172,198,0,2022-01-26 21:32:00
4280.5,165,182,4281.75,4279.0,4279.5,13,/Date(1643250780000)/,354,449,0,0,189,267,0,2022-01-26 21:33:00
4278.75,298,385,4280.25,4277.0,4280.25,13,/Date(1643250840000)/,572,698,0,0,274,313,0,2022-01-26 21:34:00
4278.25,165,236,4280.0,4277.5,4278.75,13,/Date(1643250900000)/,363,501,0,0,198,265,0,2022-01-26 21:35:00
4278.5,72,81,4279.25,4277.75,4278.25,13,/Date(1643250960000)/,179,199,0,0,107,118,0,2022-01-26 21:36:00
4284.5,239,275,4285.0,4278.5,4278.75,13,/Date(1643251020000)/,855,1113,0,0,616,838,0,2022-01-26 21:37:00
4284.25,324,390,4285.0,4282.25,4284.5,13,/Date(1643251080000)/,617,722,0,0,293,332,0,2022-01-26 21:38:00
4289.25,438,536,4290.25,4284.25,4284.25,13,/Date(1643251140000)/,1102,1350,0,0,664,814,0,2022-01-26 21:39:00
4291.25,268,308,4291.75,4289.0,4289.0,13,/Date(1643251200000)/,629,766,0,0,361,458,0,2022-01-26 21:40:00
4291.5,296,426,4292.5,4289.75,4291.25,13,/Date(1643251260000)/,649,839,0,0,353,413,0,2022-01-26 21:41:00
4292.25,232,248,4293.5,4291.25,4291.75,13,/Date(1643251320000)/,452,572,0,0,220,324,0,2022-01-26 21:42:00
4289.5,303,335,4293.5,4289.0,4292.25,13,/Date(1643251380000)/,553,618,0,0,250,283,0,2022-01-26 21:43:00
4290.25,96,134,4291.25,4289.0,4290.0,13,/Date(1643251440000)/,218,266,0,0,122,132,0,2022-01-26 21:44:00
4290.0,75,86,4292.0,4289.5,4290.0,13,/Date(1643251500000)/,173,187,0,0,98,101,0,2022-01-26 21:45:00
4294.75,123,150,4295.25,4290.25,4290.25,13,/Date(1643251560000)/,413,484,0,0,290,334,0,2022-01-26 21:46:00
4294.0,216,229,4295.0,4293.0,4294.75,13,/Date(1643251620000)/,449,488,0,0,233,259,0,2022-01-26 21:47:00
4295.75,204,254,4297.0,4293.75,4294.0,13,/Date(1643251680000)/,477,567,0,0,273,313,0,2022-01-26 21:48:00
4296.5,188,207,4296.75,4294.0,4295.75,13,/Date(1643251740000)/,376,452,0,0,188,245,0,2022-01-26 21:49:00
4294.0,174,219,4296.5,4293.5,4296.5,13,/Date(1643251800000)/,316,380,0,0,142,161,0,2022-01-26 21:50:00
4293.0,155,163,4294.5,4293.0,4294.25,13,/Date(1643251860000)/,270,289,0,0,115,126,0,2022-01-26 21:51:00
4294.75,122,132,4295.5,4293.0,4293.0,13,/Date(1643251920000)/,306,405,0,0,184,273,0,2022-01-26 21:52:00
4291.25,241,268,4295.0,4291.25,4295.0,13,/Date(1643251980000)/,391,433,0,0,150,165,0,2022-01-26 21:53:00
4291.5,82,95,4292.5,4291.25,4291.25,13,/Date(1643252040000)/,205,231,0,0,123,136,0,2022-01-26 21:54:00
4292.0,134,151,4293.75,4290.5,4291.25,13,/Date(1643252100000)/,262,287,0,0,128,136,0,2022-01-26 21:55:00
4288.75,570,643,4292.5,4287.25,4292.25,13,/Date(1643252160000)/,840,1014,0,0,270,371,0,2022-01-26 21:56:00
4287.5,228,250,4289.0,4286.75,4288.75,13,/Date(1643252220000)/,403,439,0,0,175,189,0,2022-01-26 21:57:00
4288.25,130,145,4289.0,4286.25,4287.5,13,/Date(1643252280000)/,243,273,0,0,113,128,0,2022-01-26 21:58:00
4288.75,84,86,4289.5,4287.25,4288.5,13,/Date(1643252340000)/,193,201,0,0,109,115,0,2022-01-26 21:59:00
4287.5,92,134,4289.5,4287.0,4289.0,13,/Date(1643252400000)/,168,214,0,0,76,80,0,2022-01-26 22:00:00
4289.25,100,113,4290.0,4287.25,4287.75,13,/Date(1643252460000)/,273,313,0,0,173,200,0,2022-01-26 22:01:00
4288.25,97,117,4289.5,4287.5,4289.5,13,/Date(1643252520000)/,168,195,0,0,71,78,0,2022-01-26 22:02:00
4288.25,59,67,4288.75,4287.25,4288.75,13,/Date(1643252580000)/,111,120,0,0,52,53,0,2022-01-26 22:03:00
4287.5,68,72,4288.75,4287.25,4288.25,13,/Date(1643252640000)/,127,137,0,0,59,65,0,2022-01-26 22:04:00
4282.0,625,683,4287.75,4281.25,4287.5,13,/Date(1643252700000)/,999,1137,0,0,374,454,0,2022-01-26 22:05:00
4281.75,120,131,4283.0,4281.5,4282.25,13,/Date(1643252760000)/,247,275,0,0,127,144,0,2022-01-26 22:06:00
4281.0,216,273,4282.25,4280.0,4281.5,13,/Date(1643252820000)/,400,478,0,0,184,205,0,2022-01-26 22:07:00
4284.0,90,99,4284.0,4280.75,4280.75,13,/Date(1643252880000)/,274,307,0,0,184,208,0,2022-01-26 22:08:00
4285.25,108,119,4285.75,4283.75,4284.25,13,/Date(1643252940000)/,256,312,0,0,148,193,0,2022-01-26 22:09:00
4286.75,109,130,4287.75,4285.25,4285.25,13,/Date(1643253000000)/,284,322,0,0,175,192,0,2022-01-26 22:10:00
4284.75,134,155,4287.25,4284.5,4286.75,13,/Date(1643253060000)/,258,296,0,0,124,141,0,2022-01-26 22:11:00
4285.5,80,95,4285.75,4284.25,4284.5,13,/Date(1643253120000)/,149,174,0,0,69,79,0,2022-01-26 22:12:00
4284.5,128,148,4285.5,4283.5,4285.5,13,/Date(1643253180000)/,200,233,0,0,72,85,0,2022-01-26 22:13:00
4284.0,36,45,4284.75,4283.75,4284.5,13,/Date(1643253240000)/,69,78,0,0,33,33,0,2022-01-26 22:14:00
4283.75,61,70,4285.5,4283.5,4284.25,13,/Date(1643253300000)/,136,156,0,0,75,86,0,2022-01-26 22:15:00
4284.5,124,190,4285.0,4283.75,4284.0,13,/Date(1643253360000)/,222,311,0,0,98,121,0,2022-01-26 22:16:00
4284.25,84,105,4285.0,4283.25,4285.0,13,/Date(1643253420000)/,124,146,0,0,40,41,0,2022-01-26 22:17:00
4283.0,107,118,4284.5,4282.75,4284.0,13,/Date(1643253480000)/,147,162,0,0,40,44,0,2022-01-26 22:18:00
4287.75,186,197,4289.75,4283.0,4283.0,13,/Date(1643253540000)/,561,654,0,0,375,457,0,2022-01-26 22:19:00
4290.75,183,217,4291.25,4287.75,4287.75,13,/Date(1643253600000)/,457,587,0,0,274,370,0,2022-01-26 22:20:00
4292.75,322,341,4294.75,4290.75,4290.75,13,/Date(1643253660000)/,672,733,0,0,350,392,0,2022-01-26 22:21:00
4291.0,123,141,4292.5,4290.25,4292.5,13,/Date(1643253720000)/,213,239,0,0,90,98,0,2022-01-26 22:22:00
4290.25,129,150,4291.5,4289.25,4290.75,13,/Date(1643253780000)/,213,255,0,0,84,105,0,2022-01-26 22:23:00
4290.5,42,42,4291.5,4289.5,4290.0,13,/Date(1643253840000)/,133,139,0,0,91,97,0,2022-01-26 22:24:00
4289.75,142,164,4293.25,4289.5,4290.5,13,/Date(1643253900000)/,277,316,0,0,135,152,0,2022-01-26 22:25:00
4287.75,184,206,4290.25,4287.0,4289.5,13,/Date(1643253960000)/,286,338,0,0,102,132,0,2022-01-26 22:26:00
4288.0,44,48,4288.75,4287.0,4288.0,13,/Date(1643254020000)/,121,134,0,0,77,86,0,2022-01-26 22:27:00
4288.25,42,53,4289.25,4288.0,4288.0,13,/Date(1643254080000)/,138,174,0,0,96,121,0,2022-01-26 22:28:00
4289.25,46,58,4289.5,4287.75,4288.25,13,/Date(1643254140000)/,124,150,0,0,78,92,0,2022-01-26 22:29:00
4288.75,54,77,4289.75,4288.25,4289.0,13,/Date(1643254200000)/,108,150,0,0,54,73,0,2022-01-26 22:30:00
4288.75,154,200,4290.25,4287.5,4288.75,13,/Date(1643254260000)/,303,374,0,0,149,174,0,2022-01-26 22:31:00
4293.25,147,151,4293.75,4289.0,4289.0,13,/Date(1643254320000)/,386,453,0,0,239,302,0,2022-01-26 22:32:00
4291.75,149,190,4293.25,4291.5,4293.25,13,/Date(1643254380000)/,258,320,0,0,109,130,0,2022-01-26 22:33:00
4291.5,88,100,4292.75,4290.75,4291.75,13,/Date(1643254440000)/,167,215,0,0,79,115,0,2022-01-26 22:34:00
4290.5,101,117,4291.75,4290.0,4291.75,13,/Date(1643254500000)/,178,195,0,0,77,78,0,2022-01-26 22:35:00
4287.5,217,242,4290.75,4287.0,4290.75,13,/Date(1643254560000)/,356,391,0,0,139,149,0,2022-01-26 22:36:00
4287.5,110,123,4288.75,4287.25,4287.25,13,/Date(1643254620000)/,182,226,0,0,72,103,0,2022-01-26 22:37:00
4288.0,87,99,4288.5,4287.5,4287.75,13,/Date(1643254680000)/,165,191,0,0,78,92,0,2022-01-26 22:38:00
4281.25,451,521,4288.75,4281.0,4288.0,13,/Date(1643254740000)/,666,755,0,0,215,234,0,2022-01-26 22:39:00
4281.75,206,257,4282.5,4280.75,4281.25,13,/Date(1643254800000)/,411,509,0,0,205,252,0,2022-01-26 22:40:00
4280.0,322,415,4282.25,4279.25,4281.75,13,/Date(1643254860000)/,492,595,0,0,170,180,0,2022-01-26 22:41:00
4267.0,1385,2189,4280.0,4265.0,4279.75,13,/Date(1643254920000)/,2238,3403,0,0,853,1214,0,2022-01-26 22:42:00
4272.0,397,458,4272.5,4266.5,4267.25,13,/Date(1643254980000)/,1006,1213,0,0,609,755,0,2022-01-26 22:43:00
4271.0,218,268,4272.25,4269.75,4271.75,13,/Date(1643255040000)/,414,483,0,0,196,215,0,2022-01-26 22:44:00
4269.5,465,547,4271.75,4268.0,4270.75,13,/Date(1643255100000)/,708,830,0,0,243,283,0,2022-01-26 22:45:00
4268.75,173,199,4271.0,4267.25,4269.75,13,/Date(1643255160000)/,319,356,0,0,146,157,0,2022-01-26 22:46:00
4267.75,437,593,4269.25,4265.0,4269.0,13,/Date(1643255220000)/,741,922,0,0,304,329,0,2022-01-26 22:47:00
4267.5,167,191,4269.75,4267.5,4268.0,13,/Date(1643255280000)/,310,358,0,0,143,167,0,2022-01-26 22:48:00
4264.5,492,837,4268.75,4263.25,4267.75,13,/Date(1643255340000)/,770,1178,0,0,278,341,0,2022-01-26 22:49:00
4268.0,252,297,4270.25,4264.5,4264.5,13,/Date(1643255400000)/,652,732,0,0,400,435,0,2022-01-26 22:50:00
4270.0,228,255,4270.75,4268.0,4268.5,13,/Date(1643255460000)/,426,484,0,0,198,229,0,2022-01-26 22:51:00
4271.5,299,329,4273.5,4270.0,4270.25,13,/Date(1643255520000)/,680,795,0,0,381,466,0,2022-01-26 22:52:00
4267.75,308,350,4272.5,4267.25,4271.75,13,/Date(1643255580000)/,549,600,0,0,241,250,0,2022-01-26 22:53:00
4271.25,165,177,4271.25,4267.5,4267.75,13,/Date(1643255640000)/,432,469,0,0,267,292,0,2022-01-26 22:54:00
4270.25,142,161,4271.75,4269.25,4271.0,13,/Date(1643255700000)/,280,312,0,0,138,151,0,2022-01-26 22:55:00
4270.0,249,277,4270.25,4266.5,4270.0,13,/Date(1643255760000)/,436,492,0,0,187,215,0,2022-01-26 22:56:00
4268.75,96,108,4270.25,4267.25,4269.75,13,/Date(1643255820000)/,197,215,0,0,101,107,0,2022-01-26 22:57:00
4269.75,77,81,4270.25,4267.75,4268.75,13,/Date(1643255880000)/,182,200,0,0,105,119,0,2022-01-26 22:58:00
4268.5,457,561,4271.25,4265.5,4269.75,13,/Date(1643255940000)/,813,950,0,0,356,389,0,2022-01-26 22:59:00
4271.75,190,203,4273.0,4268.25,4268.5,13,/Date(1643256000000)/,479,515,0,0,289,312,0,2022-01-26 23:00:00
4271.75,146,163,4272.5,4270.25,4271.75,13,/Date(1643256060000)/,310,334,0,0,164,171,0,2022-01-26 23:01:00
4273.25,262,289,4274.5,4271.25,4271.5,13,/Date(1643256120000)/,563,616,0,0,301,327,0,2022-01-26 23:02:00
4271.0,156,186,4273.5,4270.0,4273.25,13,/Date(1643256180000)/,238,278,0,0,82,92,0,2022-01-26 23:03:00
4270.75,120,135,4271.25,4269.25,4270.5,13,/Date(1643256240000)/,224,246,0,0,104,111,0,2022-01-26 23:04:00
4270.25,98,118,4271.0,4269.0,4270.75,13,/Date(1643256300000)/,201,232,0,0,103,114,0,2022-01-26 23:05:00
4271.5,71,76,4271.5,4269.5,4270.25,13,/Date(1643256360000)/,175,188,0,0,104,112,0,2022-01-26 23:06:00
4269.25,130,143,4272.25,4268.5,4271.5,13,/Date(1643256420000)/,237,256,0,0,107,113,0,2022-01-26 23:07:00
4268.5,54,57,4269.75,4268.5,4269.25,13,/Date(1643256480000)/,142,156,0,0,88,99,0,2022-01-26 23:08:00
4271.0,75,76,4271.0,4268.25,4268.5,13,/Date(1643256540000)/,153,164,0,0,78,88,0,2022-01-26 23:09:00
4270.5,64,74,4271.0,4269.25,4270.75,13,/Date(1643256600000)/,131,150,0,0,67,76,0,2022-01-26 23:10:00
4269.5,114,132,4270.75,4268.25,4270.5,13,/Date(1643256660000)/,190,212,0,0,76,80,0,2022-01-26 23:11:00
4270.0,165,175,4273.25,4269.75,4270.0,13,/Date(1643256720000)/,364,394,0,0,199,219,0,2022-01-26 23:12:00
4271.5,63,63,4272.25,4270.5,4270.5,13,/Date(1643256780000)/,142,145,0,0,79,82,0,2022-01-26 23:13:00
4271.5,82,85,4272.5,4270.75,4271.5,13,/Date(1643256840000)/,133,136,0,0,51,51,0,2022-01-26 23:14:00
4272.25,44,45,4272.25,4270.5,4271.5,13,/Date(1643256900000)/,106,112,0,0,62,67,0,2022-01-26 23:15:00
4270.0,137,159,4272.25,4269.25,4271.75,13,/Date(1643256960000)/,199,223,0,0,62,64,0,2022-01-26 23:16:00
4271.5,56,59,4272.0,4269.5,4270.25,13,/Date(1643257020000)/,129,140,0,0,73,81,0,2022-01-26 23:17:00
4271.0,97,107,4272.0,4269.75,4271.25,13,/Date(1643257080000)/,155,168,0,0,58,61,0,2022-01-26 23:18:00
4273.0,54,55,4273.5,4271.25,4271.5,13,/Date(1643257140000)/,139,163,0,0,85,108,0,2022-01-26 23:19:00
4276.75,205,221,4277.75,4272.75,4273.0,13,/Date(1643257200000)/,534,594,0,0,329,373,0,2022-01-26 23:20:00
4275.75,189,204,4278.0,4275.0,4276.75,13,/Date(1643257260000)/,381,410,0,0,192,206,0,2022-01-26 23:21:00
4275.5,122,131,4276.5,4274.5,4275.5,13,/Date(1643257320000)/,216,240,0,0,94,109,0,2022-01-26 23:22:00
4277.25,91,106,4277.75,4275.0,4275.5,13,/Date(1643257380000)/,179,212,0,0,88,106,0,2022-01-26 23:23:00
4277.0,93,98,4277.5,4275.25,4277.5,13,/Date(1643257440000)/,192,217,0,0,99,119,0,2022-01-26 23:24:00
4276.5,106,116,4278.0,4276.25,4277.0,13,/Date(1643257500000)/,183,203,0,0,77,87,0,2022-01-26 23:25:00
4278.0,92,105,4278.0,4275.25,4276.5,13,/Date(1643257560000)/,200,230,0,0,108,125,0,2022-01-26 23:26:00
4277.5,135,140,4279.75,4277.25,4278.0,13,/Date(1643257620000)/,262,320,0,0,127,180,0,2022-01-26 23:27:00
4280.75,111,120,4281.0,4276.5,4277.25,13,/Date(1643257680000)/,311,326,0,0,200,206,0,2022-01-26 23:28:00
4280.5,279,387,4282.0,4279.75,4280.5,13,/Date(1643257740000)/,532,686,0,0,253,299,0,2022-01-26 23:29:00
4280.5,94,113,4281.0,4279.5,4280.5,13,/Date(1643257800000)/,197,233,0,0,103,120,0,2022-01-26 23:30:00
4280.5,89,106,4280.75,4279.5,4280.75,13,/Date(1643257860000)/,188,217,0,0,99,111,0,2022-01-26 23:31:00
4282.0,149,189,4282.75,4279.5,4280.5,13,/Date(1643257920000)/,374,479,0,0,225,290,0,2022-01-26 23:32:00
4282.0,277,295,4285.0,4281.75,4281.75,13,/Date(1643257980000)/,543,582,0,0,266,287,0,2022-01-26 23:33:00
4283.5,70,76,4284.75,4282.0,4282.0,13,/Date(1643258040000)/,187,196,0,0,117,120,0,2022-01-26 23:34:00
4283.5,92,107,4284.75,4283.25,4283.5,13,/Date(1643258100000)/,173,205,0,0,81,98,0,2022-01-26 23:35:00
4284.25,77,79,4284.5,4282.25,4283.5,13,/Date(1643258160000)/,206,218,0,0,129,139,0,2022-01-26 23:36:00
4282.75,88,102,4284.0,4282.0,4284.0,13,/Date(1643258220000)/,125,140,0,0,37,38,0,2022-01-26 23:37:00
4283.0,85,96,4284.0,4282.25,4282.5,13,/Date(1643258280000)/,167,181,0,0,82,85,0,2022-01-26 23:38:00
4282.25,134,142,4284.75,4282.25,4283.25,13,/Date(1643258340000)/,217,233,0,0,83,91,0,2022-01-26 23:39:00
4283.5,40,43,4284.25,4282.5,4282.5,13,/Date(1643258400000)/,99,108,0,0,59,65,0,2022-01-26 23:40:00
4282.0,65,70,4283.75,4281.5,4283.25,13,/Date(1643258460000)/,108,116,0,0,43,46,0,2022-01-26 23:41:00
4280.5,77,77,4282.5,4280.5,4282.25,13,/Date(1643258520000)/,147,184,0,0,70,107,0,2022-01-26 23:42:00
4278.25,290,400,4282.0,4277.75,4280.5,13,/Date(1643258580000)/,446,563,0,0,156,163,0,2022-01-26 23:43:00
4279.5,98,102,4280.75,4278.0,4278.25,13,/Date(1643258640000)/,212,237,0,0,114,135,0,2022-01-26 23:44:00
4279.25,48,52,4280.25,4278.75,4279.5,13,/Date(1643258700000)/,94,104,0,0,46,52,0,2022-01-26 23:45:00
4279.25,37,37,4280.5,4279.25,4279.5,13,/Date(1643258760000)/,105,118,0,0,68,81,0,2022-01-26 23:46:00
4278.25,96,106,4281.0,4278.0,4279.5,13,/Date(1643258820000)/,152,162,0,0,56,56,0,2022-01-26 23:47:00
4278.75,26,27,4280.0,4278.0,4278.25,13,/Date(1643258880000)/,68,74,0,0,42,47,0,2022-01-26 23:48:00
4279.75,72,87,4281.0,4279.0,4279.0,13,/Date(1643258940000)/,190,216,0,0,118,129,0,2022-01-26 23:49:00
4279.0,79,92,4280.25,4278.5,4280.0,13,/Date(1643259000000)/,107,124,0,0,28,32,0,2022-01-26 23:50:00
4279.5,19,20,4280.0,4278.75,4278.75,13,/Date(1643259060000)/,47,52,0,0,28,32,0,2022-01-26 23:51:00
4279.5,68,73,4280.0,4278.5,4279.5,13,/Date(1643259120000)/,125,134,0,0,57,61,0,2022-01-26 23:52:00
4281.5,63,65,4282.0,4279.75,4279.75,13,/Date(1643259180000)/,191,202,0,0,128,137,0,2022-01-26 23:53:00
4281.75,49,67,4282.5,4281.25,4281.75,13,/Date(1643259240000)/,97,119,0,0,48,52,0,2022-01-26 23:54:00
4280.25,58,66,4281.75,4279.75,4281.75,13,/Date(1643259300000)/,110,119,0,0,52,53,0,2022-01-26 23:55:00
4280.75,17,17,4281.25,4280.25,4280.5,13,/Date(1643259360000)/,37,37,0,0,20,20,0,2022-01-26 23:56:00
4281.0,43,46,4281.25,4280.0,4280.25,13,/Date(1643259420000)/,129,138,0,0,86,92,0,2022-01-26 23:57:00
4281.75,50,50,4282.5,4280.25,4281.0,13,/Date(1643259480000)/,125,138,0,0,75,88,0,2022-01-26 23:58:00
4281.75,80,85,4282.75,4280.5,4282.0,13,/Date(1643259540000)/,155,175,0,0,75,90,0,2022-01-26 23:59:00
4281.75,50,54,4282.0,4280.5,4282.0,13,/Date(1643259600000)/,120,128,0,0,70,74,0,2022-01-27 00:00:00
4282.0,106,122,4283.25,4281.25,4282.0,13,/Date(1643259660000)/,249,304,0,0,143,182,0,2022-01-27 00:01:00
4282.75,160,174,4284.75,4281.5,4281.75,13,/Date(1643259720000)/,350,395,0,0,190,221,0,2022-01-27 00:02:00
4285.75,174,211,4286.0,4281.5,4282.5,13,/Date(1643259780000)/,481,692,0,0,307,481,0,2022-01-27 00:03:00
4287.25,144,155,4287.25,4285.25,4285.75,13,/Date(1643259840000)/,298,326,0,0,154,171,0,2022-01-27 00:04:00
4290.75,320,351,4291.0,4286.75,4287.25,13,/Date(1643259900000)/,716,881,0,0,396,530,0,2022-01-27 00:05:00
4291.0,245,270,4291.75,4289.75,4291.0,13,/Date(1643259960000)/,459,525,0,0,214,255,0,2022-01-27 00:06:00
4290.25,138,165,4291.25,4289.0,4291.0,13,/Date(1643260020000)/,240,278,0,0,102,113,0,2022-01-27 00:07:00
4290.75,136,166,4291.25,4289.25,4290.0,13,/Date(1643260080000)/,243,285,0,0,107,119,0,2022-01-27 00:08:00
4287.0,237,267,4290.75,4286.5,4290.5,13,/Date(1643260140000)/,307,337,0,0,70,70,0,2022-01-27 00:09:00
4286.0,172,196,4286.75,4285.75,4286.75,13,/Date(1643260200000)/,260,297,0,0,88,101,0,2022-01-27 00:10:00
4286.0,149,168,4286.5,4285.0,4286.0,13,/Date(1643260260000)/,281,333,0,0,132,165,0,2022-01-27 00:11:00
4285.75,76,90,4286.5,4285.0,4286.0,13,/Date(1643260320000)/,171,190,0,0,95,100,0,2022-01-27 00:12:00
4285.75,73,84,4286.0,4285.0,4285.75,13,/Date(1643260380000)/,112,131,0,0,39,47,0,2022-01-27 00:13:00
4283.25,191,221,4285.75,4282.75,4285.75,13,/Date(1643260440000)/,281,324,0,0,90,103,0,2022-01-27 00:14:00
4281.0,312,372,4283.25,4280.5,4283.25,13,/Date(1643260500000)/,534,603,0,0,222,231,0,2022-01-27 00:15:00
4277.0,483,576,4281.25,4275.5,4281.0,13,/Date(1643260560000)/,753,910,0,0,270,334,0,2022-01-27 00:16:00
4277.5,190,215,4278.75,4275.5,4276.75,13,/Date(1643260620000)/,412,481,0,0,222,266,0,2022-01-27 00:17:00
4276.0,170,187,4277.5,4275.0,4277.5,13,/Date(1643260680000)/,329,409,0,0,159,222,0,2022-01-27 00:18:00
4275.25,151,221,4277.0,4274.0,4275.75,13,/Date(1643260740000)/,243,387,0,0,92,166,0,2022-01-27 00:19:00
4271.75,328,387,4275.25,4271.0,4275.25,13,/Date(1643260800000)/,576,713,0,0,248,326,0,2022-01-27 00:20:00
4273.25,72,88,4273.75,4271.75,4271.75,13,/Date(1643260860000)/,219,276,0,0,147,188,0,2022-01-27 00:21:00
4274.25,80,102,4274.5,4272.75,4273.5,13,/Date(1643260920000)/,183,292,0,0,103,190,0,2022-01-27 00:22:00
4274.0,52,56,4274.5,4273.0,4274.5,13,/Date(1643260980000)/,104,113,0,0,52,57,0,2022-01-27 00:23:00
4275.5,130,170,4276.25,4273.25,4274.5,13,/Date(1643261040000)/,265,361,0,0,135,191,0,2022-01-27 00:24:00
4273.75,124,134,4276.0,4273.5,4275.25,13,/Date(1643261100000)/,195,225,0,0,71,91,0,2022-01-27 00:25:00
4274.5,83,89,4275.5,4274.0,4274.0,13,/Date(1643261160000)/,135,154,0,0,52,65,0,2022-01-27 00:26:00
4274.0,139,186,4275.25,4273.0,4275.0,13,/Date(1643261220000)/,235,303,0,0,96,117,0,2022-01-27 00:27:00
4274.5,36,37,4275.25,4274.0,4274.25,13,/Date(1643261280000)/,92,98,0,0,56,61,0,2022-01-27 00:28:00
4277.75,101,138,4278.75,4274.75,4274.75,13,/Date(1643261340000)/,318,393,0,0,217,255,0,2022-01-27 00:29:00
4277.5,53,55,4277.75,4276.25,4277.5,13,/Date(1643261400000)/,116,129,0,0,63,74,0,2022-01-27 00:30:00
4277.5,76,78,4278.0,4276.5,4277.5,13,/Date(1643261460000)/,134,147,0,0,58,69,0,2022-01-27 00:31:00
4281.75,131,164,4282.0,4277.25,4277.5,13,/Date(1643261520000)/,371,451,0,0,240,287,0,2022-01-27 00:32:00
4285.0,276,357,4287.5,4281.75,4281.75,13,/Date(1643261580000)/,663,841,0,0,387,484,0,2022-01-27 00:33:00
4283.5,120,128,4286.0,4283.5,4285.0,13,/Date(1643261640000)/,207,234,0,0,87,106,0,2022-01-27 00:34:00
4286.0,134,166,4287.25,4283.25,4283.5,13,/Date(1643261700000)/,311,399,0,0,177,233,0,2022-01-27 00:35:00
4287.75,138,172,4288.25,4286.0,4286.0,13,/Date(1643261760000)/,322,396,0,0,184,224,0,2022-01-27 00:36:00
4285.0,198,222,4288.75,4284.5,4287.75,13,/Date(1643261820000)/,350,384,0,0,152,162,0,2022-01-27 00:37:00
4285.0,97,108,4286.5,4284.25,4285.25,13,/Date(1643261880000)/,180,210,0,0,83,102,0,2022-01-27 00:38:00
4287.25,75,89,4287.75,4284.5,4284.75,13,/Date(1643261940000)/,188,209,0,0,113,120,0,2022-01-27 00:39:00
4286.5,99,139,4288.5,4285.75,4287.0,13,/Date(1643262000000)/,199,246,0,0,100,107,0,2022-01-27 00:40:00
4285.75,75,81,4287.75,4285.5,4287.0,13,/Date(1643262060000)/,118,130,0,0,43,49,0,2022-01-27 00:41:00
4284.0,128,156,4286.25,4283.5,4285.75,13,/Date(1643262120000)/,210,244,0,0,82,88,0,2022-01-27 00:42:00
4284.5,59,68,4284.75,4283.75,4284.0,13,/Date(1643262180000)/,104,113,0,0,45,45,0,2022-01-27 00:43:00
4284.0,74,77,4284.75,4283.0,4284.5,13,/Date(1643262240000)/,117,133,0,0,43,56,0,2022-01-27 00:44:00
4287.75,94,125,4289.5,4284.5,4284.5,13,/Date(1643262300000)/,323,393,0,0,229,268,0,2022-01-27 00:45:00
4285.75,69,82,4288.0,4285.75,4288.0,13,/Date(1643262360000)/,130,143,0,0,61,61,0,2022-01-27 00:46:00
4286.25,98,112,4287.25,4283.75,4285.5,13,/Date(1643262420000)/,252,278,0,0,154,166,0,2022-01-27 00:47:00
4286.75,78,97,4287.75,4286.25,4286.5,13,/Date(1643262480000)/,119,152,0,0,41,55,0,2022-01-27 00:48:00
4287.5,29,30,4287.5,4286.25,4287.25,13,/Date(1643262540000)/,75,76,0,0,46,46,0,2022-01-27 00:49:00
4287.0,46,46,4287.0,4285.75,4287.0,13,/Date(1643262600000)/,96,97,0,0,50,51,0,2022-01-27 00:50:00
4287.0,67,72,4288.25,4286.5,4286.75,13,/Date(1643262660000)/,144,164,0,0,77,92,0,2022-01-27 00:51:00
4283.5,193,288,4286.75,4283.0,4286.5,13,/Date(1643262720000)/,251,347,0,0,58,59,0,2022-01-27 00:52:00
4283.5,136,140,4284.25,4282.25,4283.75,13,/Date(1643262780000)/,240,269,0,0,104,129,0,2022-01-27 00:53:00
4284.25,74,75,4285.0,4282.0,4283.25,13,/Date(1643262840000)/,148,154,0,0,74,79,0,2022-01-27 00:54:00
4284.75,100,113,4285.75,4284.0,4284.0,13,/Date(1643262900000)/,223,254,0,0,123,141,0,2022-01-27 00:55:00
4283.25,50,51,4284.75,4283.25,4284.25,13,/Date(1643262960000)/,114,119,0,0,64,68,0,2022-01-27 00:56:00
4284.5,57,62,4284.5,4282.5,4283.0,13,/Date(1643263020000)/,96,101,0,0,39,39,0,2022-01-27 00:57:00
4283.25,49,50,4285.0,4282.25,4284.25,13,/Date(1643263080000)/,119,121,0,0,70,71,0,2022-01-27 00:58:00
4286.5,53,63,4287.0,4283.0,4283.0,13,/Date(1643263140000)/,177,212,0,0,124,149,0,2022-01-27 00:59:00
4285.5,75,75,4287.0,4284.25,4286.0,13,/Date(1643263200000)/,148,150,0,0,73,75,0,2022-01-27 01:00:00
4284.25,212,234,4288.75,4283.5,4285.0,13,/Date(1643263260000)/,367,415,0,0,155,181,0,2022-01-27 01:01:00
4286.0,101,130,4286.0,4282.5,4284.25,13,/Date(1643263320000)/,242,318,0,0,141,188,0,2022-01-27 01:02:00
4287.0,163,203,4289.0,4285.25,4286.0,13,/Date(1643263380000)/,333,395,0,0,170,192,0,2022-01-27 01:03:00
4285.25,109,132,4288.0,4285.0,4287.25,13,/Date(1643263440000)/,183,241,0,0,74,109,0,2022-01-27 01:04:00
4284.25,154,224,4285.75,4283.0,4285.25,13,/Date(1643263500000)/,244,318,0,0,90,94,0,2022-01-27 01:05:00
4282.0,165,196,4284.5,4281.5,4284.0,13,/Date(1643263560000)/,238,277,0,0,73,81,0,2022-01-27 01:06:00
4283.75,53,57,4284.0,4282.5,4282.5,13,/Date(1643263620000)/,138,181,0,0,85,124,0,2022-01-27 01:07:00
4284.25,78,80,4286.5,4283.5,4284.0,13,/Date(1643263680000)/,184,208,0,0,106,128,0,2022-01-27 01:08:00
4287.25,37,38,4287.75,4284.25,4284.25,13,/Date(1643263740000)/,138,156,0,0,101,118,0,2022-01-27 01:09:00
4290.75,232,293,4291.25,4287.25,4287.25,13,/Date(1643263800000)/,616,848,0,0,384,555,0,2022-01-27 01:10:00
4292.0,226,274,4293.75,4290.5,4290.5,13,/Date(1643263860000)/,485,595,0,0,259,321,0,2022-01-27 01:11:00
4295.25,182,196,4296.75,4291.75,4291.75,13,/Date(1643263920000)/,494,585,0,0,312,389,0,2022-01-27 01:12:00
4295.0,117,117,4296.75,4294.5,4295.25,13,/Date(1643263980000)/,220,229,0,0,103,112,0,2022-01-27 01:13:00
4293.25,153,164,4295.5,4292.5,4295.0,13,/Date(1643264040000)/,256,367,0,0,103,203,0,2022-01-27 01:14:00
4293.75,132,164,4294.5,4292.25,4293.25,13,/Date(1643264100000)/,232,270,0,0,100,106,0,2022-01-27 01:15:00
4291.5,131,147,4294.25,4291.25,4293.75,13,/Date(1643264160000)/,213,231,0,0,82,84,0,2022-01-27 01:16:00
4289.0,229,379,4292.25,4288.5,4292.0,13,/Date(1643264220000)/,343,500,0,0,114,121,0,2022-01-27 01:17:00
4289.5,141,163,4290.0,4287.75,4288.5,13,/Date(1643264280000)/,228,261,0,0,87,98,0,2022-01-27 01:18:00
4289.75,79,84,4290.5,4288.25,4289.5,13,/Date(1643264340000)/,140,165,0,0,61,81,0,2022-01-27 01:19:00
4289.25,85,92,4290.75,4288.5,4289.5,13,/Date(1643264400000)/,145,155,0,0,60,63,0,2022-01-27 01:20:00
4288.5,120,156,4290.75,4286.75,4288.75,13,/Date(1643264460000)/,224,266,0,0,104,110,0,2022-01-27 01:21:00
4289.5,48,49,4289.5,4287.0,4288.75,13,/Date(1643264520000)/,104,108,0,0,56,59,0,2022-01-27 01:22:00
4288.5,64,68,4289.75,4287.5,4289.25,13,/Date(1643264580000)/,132,162,0,0,68,94,0,2022-01-27 01:23:00
4286.0,130,154,4288.75,4285.25,4288.75,13,/Date(1643264640000)/,222,253,0,0,92,99,0,2022-01-27 01:24:00
4284.25,193,213,4287.25,4283.75,4286.0,13,/Date(1643264700000)/,269,292,0,0,76,79,0,2022-01-27 01:25:00
4282.25,179,271,4285.0,4282.0,4284.25,13,/Date(1643264760000)/,322,438,0,0,143,167,0,2022-01-27 01:26:00
4281.75,122,133,4283.75,4281.5,4282.5,13,/Date(1643264820000)/,269,294,0,0,147,161,0,2022-01-27 01:27:00
4283.25,155,203,4283.75,4279.5,4282.0,13,/Date(1643264880000)/,292,344,0,0,137,141,0,2022-01-27 01:28:00
4284.5,147,151,4286.75,4283.5,4283.5,13,/Date(1643264940000)/,338,359,0,0,191,208,0,2022-01-27 01:29:00
4281.5,200,226,4285.5,4281.0,4284.75,13,/Date(1643265000000)/,289,325,0,0,89,99,0,2022-01-27 01:30:00
4278.25,277,328,4281.25,4277.25,4281.0,13,/Date(1643265060000)/,485,558,0,0,208,230,0,2022-01-27 01:31:00
4277.5,141,147,4278.5,4276.0,4277.75,13,/Date(1643265120000)/,259,315,0,0,118,168,0,2022-01-27 01:32:00
4279.0,152,246,4279.75,4277.5,4278.0,13,/Date(1643265180000)/,286,398,0,0,134,152,0,2022-01-27 01:33:00
4280.75,109,127,4282.0,4279.5,4279.5,13,/Date(1643265240000)/,223,247,0,0,114,120,0,2022-01-27 01:34:00
4277.75,128,147,4281.25,4277.5,4280.75,13,/Date(1643265300000)/,203,233,0,0,75,86,0,2022-01-27 01:35:00
4279.0,184,197,4279.0,4275.0,4277.25,13,/Date(1643265360000)/,366,385,0,0,182,188,0,2022-01-27 01:36:00
4281.0,72,109,4281.75,4279.0,4279.0,13,/Date(1643265420000)/,197,245,0,0,125,136,0,2022-01-27 01:37:00
4282.0,45,47,4282.25,4281.0,4281.25,13,/Date(1643265480000)/,122,132,0,0,77,85,0,2022-01-27 01:38:00
4281.0,52,64,4282.0,4280.25,4281.5,13,/Date(1643265540000)/,92,107,0,0,40,43,0,2022-01-27 01:39:00
4278.75,140,154,4281.25,4278.75,4281.25,13,/Date(1643265600000)/,204,220,0,0,64,66,0,2022-01-27 01:40:00
4280.0,103,118,4281.0,4277.5,4278.5,13,/Date(1643265660000)/,219,240,0,0,116,122,0,2022-01-27 01:41:00
4280.5,84,92,4281.25,4278.75,4280.25,13,/Date(1643265720000)/,176,190,0,0,92,98,0,2022-01-27 01:42:00
4279.0,43,45,4281.0,4278.5,4280.75,13,/Date(1643265780000)/,79,88,0,0,36,43,0,2022-01-27 01:43:00
4279.0,30,51,4279.25,4278.25,4279.0,13,/Date(1643265840000)/,69,92,0,0,39,41,0,2022-01-27 01:44:00
4278.25,98,105,4280.0,4275.75,4279.5,13,/Date(1643265900000)/,143,152,0,0,45,47,0,2022-01-27 01:45:00
4273.0,276,297,4278.25,4272.75,4278.25,13,/Date(1643265960000)/,404,539,0,0,128,242,0,2022-01-27 01:46:00
4271.75,208,248,4274.25,4271.0,4272.75,13,/Date(1643266020000)/,331,466,0,0,123,218,0,2022-01-27 01:47:00
4273.5,185,222,4273.75,4271.25,4271.75,13,/Date(1643266080000)/,371,546,0,0,186,324,0,2022-01-27 01:48:00
4273.75,88,90,4274.0,4272.5,4273.75,13,/Date(1643266140000)/,183,211,0,0,95,121,0,2022-01-27 01:49:00
4269.5,354,466,4273.75,4267.5,4273.75,13,/Date(1643266200000)/,510,665,0,0,156,199,0,2022-01-27 01:50:00
4273.25,97,107,4273.5,4269.0,4269.25,13,/Date(1643266260000)/,292,312,0,0,195,205,0,2022-01-27 01:51:00
4276.25,63,65,4276.75,4273.5,4273.5,13,/Date(1643266320000)/,218,242,0,0,155,177,0,2022-01-27 01:52:00
4275.25,50,51,4277.0,4275.0,4276.25,13,/Date(1643266380000)/,103,104,0,0,53,53,0,2022-01-27 01:53:00
4276.75,68,70,4277.25,4273.25,4275.25,13,/Date(1643266440000)/,136,146,0,0,68,76,0,2022-01-27 01:54:00
4278.5,59,62,4279.0,4276.75,4276.75,13,/Date(1643266500000)/,153,177,0,0,94,115,0,2022-01-27 01:55:00
4280.75,187,203,4281.25,4278.0,4278.75,13,/Date(1643266560000)/,383,425,0,0,196,222,0,2022-01-27 01:56:00
4279.25,230,273,4281.25,4277.75,4280.5,13,/Date(1643266620000)/,386,452,0,0,156,179,0,2022-01-27 01:57:00
4279.5,56,58,4279.75,4277.75,4279.0,13,/Date(1643266680000)/,127,134,0,0,71,76,0,2022-01-27 01:58:00
4279.25,54,64,4280.75,4279.25,4279.75,13,/Date(1643266740000)/,100,111,0,0,46,47,0,2022-01-27 01:59:00
4281.25,99,104,4283.0,4278.5,4279.25,13,/Date(1643266800000)/,235,277,0,0,136,173,0,2022-01-27 02:00:00
4282.75,276,329,4284.5,4281.25,4281.5,13,/Date(1643266860000)/,487,565,0,0,211,236,0,2022-01-27 02:01:00
4285.5,120,129,4285.75,4282.75,4283.0,13,/Date(1643266920000)/,303,339,0,0,183,210,0,2022-01-27 02:02:00
4285.0,162,181,4287.5,4284.25,4286.0,13,/Date(1643266980000)/,329,361,0,0,167,180,0,2022-01-27 02:03:00
4288.0,93,107,4288.5,4284.0,4285.0,13,/Date(1643267040000)/,263,298,0,0,170,191,0,2022-01-27 02:04:00
4289.0,185,199,4289.25,4287.25,4288.0,13,/Date(1643267100000)/,365,401,0,0,180,202,0,2022-01-27 02:05:00
4291.0,174,216,4291.75,4288.0,4289.0,13,/Date(1643267160000)/,412,504,0,0,238,288,0,2022-01-27 02:06:00
4287.75,214,240,4292.5,4287.5,4291.5,13,/Date(1643267220000)/,400,447,0,0,186,207,0,2022-01-27 02:07:00
4289.0,134,153,4290.5,4288.0,4288.0,13,/Date(1643267280000)/,322,385,0,0,188,232,0,2022-01-27 02:08:00
4286.75,236,269,4290.0,4286.5,4289.25,13,/Date(1643267340000)/,463,593,0,0,227,324,0,2022-01-27 02:09:00
4285.0,171,201,4288.5,4284.5,4287.0,13,/Date(1643267400000)/,290,338,0,0,119,137,0,2022-01-27 02:10:00
4286.0,160,182,4286.25,4284.0,4285.25,13,/Date(1643267460000)/,388,477,0,0,228,295,0,2022-01-27 02:11:00
4289.75,88,95,4290.75,4286.0,4286.0,13,/Date(1643267520000)/,239,260,0,0,151,165,0,2022-01-27 02:12:00
4297.25,253,283,4297.75,4289.5,4290.0,13,/Date(1643267580000)/,1014,1246,0,0,761,963,0,2022-01-27 02:13:00
4295.5,315,357,4298.75,4295.5,4297.0,13,/Date(1643267640000)/,566,685,0,0,251,328,0,2022-01-27 02:14:00
4293.75,164,178,4295.75,4292.5,4295.25,13,/Date(1643267700000)/,273,288,0,0,109,110,0,2022-01-27 02:15:00
4299.0,206,222,4299.75,4293.25,4294.0,13,/Date(1643267760000)/,487,540,0,0,281,318,0,2022-01-27 02:16:00
4297.0,229,267,4299.5,4297.0,4299.0,13,/Date(1643267820000)/,340,382,0,0,111,115,0,2022-01-27 02:17:00
4295.25,424,460,4300.5,4295.25,4297.0,13,/Date(1643267880000)/,781,900,0,0,357,440,0,2022-01-27 02:18:00
4295.25,134,156,4297.75,4295.25,4295.5,13,/Date(1643267940000)/,229,255,0,0,95,99,0,2022-01-27 02:19:00
4298.0,90,97,4299.0,4294.75,4295.5,13,/Date(1643268000000)/,260,286,0,0,170,189,0,2022-01-27 02:20:00
4299.75,112,124,4300.25,4297.5,4297.75,13,/Date(1643268060000)/,369,421,0,0,257,297,0,2022-01-27 02:21:00
4300.0,203,223,4300.0,4297.25,4300.0,13,/Date(1643268120000)/,328,355,0,0,125,132,0,2022-01-27 02:22:00
4299.25,147,169,4300.5,4298.75,4299.75,13,/Date(1643268180000)/,238,270,0,0,91,101,0,2022-01-27 02:23:00
4296.75,188,208,4299.25,4296.5,4299.0,13,/Date(1643268240000)/,263,292,0,0,75,84,0,2022-01-27 02:24:00
4295.5,160,173,4296.75,4295.25,4296.5,13,/Date(1643268300000)/,288,327,0,0,128,154,0,2022-01-27 02:25:00
4297.5,238,263,4297.5,4293.5,4295.5,13,/Date(1643268360000)/,553,610,0,0,315,347,0,2022-01-27 02:26:00
4300.0,245,284,4301.75,4297.5,4297.5,13,/Date(1643268420000)/,640,740,0,0,395,456,0,2022-01-27 02:27:00
4298.75,190,221,4300.5,4298.5,4299.5,13,/Date(1643268480000)/,403,535,0,0,213,314,0,2022-01-27 02:28:00
4300.25,216,237,4301.25,4298.0,4298.75,13,/Date(1643268540000)/,438,502,0,0,222,265,0,2022-01-27 02:29:00
4297.75,302,322,4300.0,4297.75,4300.0,13,/Date(1643268600000)/,519,556,0,0,217,234,0,2022-01-27 02:30:00
4300.25,205,213,4300.25,4295.5,4297.75,13,/Date(1643268660000)/,526,561,0,0,321,348,0,2022-01-27 02:31:00
4300.0,355,386,4302.75,4299.25,4300.25,13,/Date(1643268720000)/,646,788,0,0,291,402,0,2022-01-27 02:32:00
4300.75,404,451,4303.25,4300.0,4300.25,13,/Date(1643268780000)/,743,821,0,0,339,370,0,2022-01-27 02:33:00
4302.5,273,326,4303.25,4300.75,4301.0,13,/Date(1643268840000)/,515,637,0,0,242,311,0,2022-01-27 02:34:00
4298.5,306,313,4304.0,4298.5,4302.75,13,/Date(1643268900000)/,606,663,0,0,300,350,0,2022-01-27 02:35:00
4300.5,161,171,4302.25,4298.0,4298.5,13,/Date(1643268960000)/,372,407,0,0,211,236,0,2022-01-27 02:36:00
4302.0,153,165,4302.0,4299.25,4300.5,13,/Date(1643269020000)/,295,354,0,0,142,189,0,2022-01-27 02:37:00
4300.75,230,247,4303.25,4300.0,4302.25,13,/Date(1643269080000)/,441,519,0,0,211,272,0,2022-01-27 02:38:00
4300.75,123,224,4302.0,4300.25,4300.5,13,/Date(1643269140000)/,336,452,0,0,213,228,0,2022-01-27 02:39:00
4301.0,133,139,4301.75,4300.25,4301.0,13,/Date(1643269200000)/,249,292,0,0,116,153,0,2022-01-27 02:40:00
4302.0,94,94,4302.75,4301.0,4301.0,13,/Date(1643269260000)/,219,237,0,0,125,143,0,2022-01-27 02:41:00
4304.5,125,127,4305.0,4302.0,4302.0,13,/Date(1643269320000)/,372,455,0,0,247,328,0,2022-01-27 02:42:00
4306.0,210,284,4306.25,4304.25,4304.25,13,/Date(1643269380000)/,492,662,0,0,282,378,0,2022-01-27 02:43:00
4304.25,252,349,4306.25,4303.25,4305.75,13,/Date(1643269440000)/,466,580,0,0,214,231,0,2022-01-27 02:44:00
4306.0,210,237,4306.5,4304.0,4304.0,13,/Date(1643269500000)/,505,574,0,0,295,337,0,2022-01-27 02:45:00
4304.5,283,339,4308.25,4304.5,4306.25,13,/Date(1643269560000)/,610,725,0,0,327,386,0,2022-01-27 02:46:00
4299.0,447,540,4305.0,4298.75,4304.5,13,/Date(1643269620000)/,704,852,0,0,257,312,0,2022-01-27 02:47:00
4299.5,181,201,4300.5,4298.5,4299.0,13,/Date(1643269680000)/,363,386,0,0,182,185,0,2022-01-27 02:48:00
4302.25,119,135,4303.25,4299.5,4299.5,13,/Date(1643269740000)/,279,306,0,0,160,171,0,2022-01-27 02:49:00
4302.25,146,153,4303.25,4301.0,4302.25,13,/Date(1643269800000)/,307,325,0,0,161,172,0,2022-01-27 02:50:00
4301.25,138,147,4303.25,4301.25,4302.25,13,/Date(1643269860000)/,224,238,0,0,86,91,0,2022-01-27 02:51:00
4303.25,72,80,4304.0,4301.25,4301.5,13,/Date(1643269920000)/,194,244,0,0,122,164,0,2022-01-27 02:52:00
4304.5,100,106,4305.5,4303.0,4303.25,13,/Date(1643269980000)/,224,241,0,0,124,135,0,2022-01-27 02:53:00
4306.75,143,184,4307.0,4304.5,4304.5,13,/Date(1643270040000)/,325,427,0,0,182,243,0,2022-01-27 02:54:00
4306.75,100,118,4307.25,4305.5,4306.75,13,/Date(1643270100000)/,201,240,0,0,101,122,0,2022-01-27 02:55:00
4305.75,83,90,4307.75,4305.5,4306.75,13,/Date(1643270160000)/,189,208,0,0,106,118,0,2022-01-27 02:56:00
4306.0,92,113,4307.0,4305.5,4305.75,13,/Date(1643270220000)/,168,190,0,0,76,77,0,2022-01-27 02:57:00
4300.75,309,328,4306.75,4300.75,4305.75,13,/Date(1643270280000)/,488,530,0,0,179,202,0,2022-01-27 02:58:00
4300.0,296,328,4301.5,4299.25,4300.75,13,/Date(1643270340000)/,516,582,0,0,220,254,0,2022-01-27 02:59:00
4298.75,439,477,4300.75,4296.5,4300.0,13,/Date(1643270400000)/,857,936,0,0,418,459,0,2022-01-27 03:00:00
4300.0,902,971,4301.25,4297.75,4299.0,13,/Date(1643270460000)/,1773,1964,0,0,871,993,0,2022-01-27 03:01:00
4304.75,438,463,4304.75,4299.75,4300.0,13,/Date(1643270520000)/,1019,1111,0,0,581,648,0,2022-01-27 03:02:00
4299.0,523,559,4305.25,4298.25,4304.75,13,/Date(1643270580000)/,1008,1090,0,0,485,531,0,2022-01-27 03:03:00
4301.5,396,429,4302.25,4298.75,4299.0,13,/Date(1643270640000)/,787,915,0,0,391,486,0,2022-01-27 03:04:00
4304.25,394,422,4305.5,4300.25,4301.75,13,/Date(1643270700000)/,809,1029,0,0,415,607,0,2022-01-27 03:05:00
4301.25,366,394,4305.75,4300.0,4304.0,13,/Date(1643270760000)/,657,718,0,0,291,324,0,2022-01-27 03:06:00
4304.25,289,335,4305.0,4301.25,4301.25,13,/Date(1643270820000)/,683,788,0,0,394,453,0,2022-01-27 03:07:00
4307.5,426,509,4309.0,4304.25,4304.25,13,/Date(1643270880000)/,1020,1292,0,0,594,783,0,2022-01-27 03:08:00
4304.0,401,454,4308.0,4303.25,4307.5,13,/Date(1643270940000)/,777,935,0,0,376,481,0,2022-01-27 03:09:00
4303.75,410,462,4305.0,4301.5,4304.0,13,/Date(1643271000000)/,770,897,0,0,360,435,0,2022-01-27 03:10:00
4301.5,316,397,4304.0,4300.75,4303.75,13,/Date(1643271060000)/,643,766,0,0,327,369,0,2022-01-27 03:11:00
4301.25,308,400,4302.25,4300.0,4301.75,13,/Date(1643271120000)/,542,759,0,0,234,359,0,2022-01-27 03:12:00
4303.75,342,467,4304.25,4299.25,4301.25,13,/Date(1643271180000)/,685,898,0,0,343,431,0,2022-01-27 03:13:00
4309.0,443,553,4309.25,4303.0,4303.75,13,/Date(1643271240000)/,1075,1386,0,0,632,833,0,2022-01-27 03:14:00
4312.75,618,709,4313.75,4308.75,4309.0,13,/Date(1643271300000)/,1472,1847,0,0,854,1138,0,2022-01-27 03:15:00
4309.75,286,316,4313.25,4309.75,4312.75,13,/Date(1643271360000)/,507,571,0,0,221,255,0,2022-01-27 03:16:00
4314.5,304,410,4315.0,4310.0,4310.0,13,/Date(1643271420000)/,650,824,0,0,346,414,0,2022-01-27 03:17:00
4317.5,415,517,4319.25,4314.75,4314.75,13,/Date(1643271480000)/,996,1207,0,0,581,690,0,2022-01-27 03:18:00
4320.75,317,414,4321.25,4317.5,4317.5,13,/Date(1643271540000)/,712,981,0,0,395,567,0,2022-01-27 03:19:00
4319.75,301,351,4320.5,4318.0,4320.5,13,/Date(1643271600000)/,551,749,0,0,250,398,0,2022-01-27 03:20:00
4321.25,341,419,4322.75,4318.75,4319.75,13,/Date(1643271660000)/,683,888,0,0,342,469,0,2022-01-27 03:21:00
4318.25,374,411,4322.5,4317.75,4321.0,13,/Date(1643271720000)/,683,853,0,0,309,442,0,2022-01-27 03:22:00
4315.5,318,380,4318.5,4314.5,4318.25,13,/Date(1643271780000)/,560,677,0,0,242,297,0,2022-01-27 03:23:00
4315.25,248,323,4316.0,4313.5,4315.5,13,/Date(1643271840000)/,457,576,0,0,209,253,0,2022-01-27 03:24:00
4314.25,130,142,4316.5,4314.0,4315.0,13,/Date(1643271900000)/,254,292,0,0,124,150,0,2022-01-27 03:25:00
4314.5,271,296,4315.75,4311.75,4314.25,13,/Date(1643271960000)/,475,545,0,0,204,249,0,2022-01-27 03:26:00
4310.75,276,414,4314.75,4310.25,4314.5,13,/Date(1643272020000)/,446,606,0,0,170,192,0,2022-01-27 03:27:00
4313.0,177,198,4313.25,4310.5,4311.0,13,/Date(1643272080000)/,372,443,0,0,195,245,0,2022-01-27 03:28:00
4314.5,205,217,4315.25,4312.5,4313.25,13,/Date(1643272140000)/,411,541,0,0,206,324,0,2022-01-27 03:29:00
4312.25,267,347,4315.75,4309.75,4314.5,13,/Date(1643272200000)/,419,520,0,0,152,173,0,2022-01-27 03:30:00
4311.25,207,233,4314.25,4311.0,4312.5,13,/Date(1643272260000)/,402,489,0,0,195,256,0,2022-01-27 03:31:00
4308.5,248,384,4311.75,4308.25,4311.25,13,/Date(1643272320000)/,521,693,0,0,273,309,0,2022-01-27 03:32:00
4309.0,290,368,4309.5,4306.75,4308.5,13,/Date(1643272380000)/,605,779,0,0,315,411,0,2022-01-27 03:33:00
4310.75,224,296,4312.5,4308.75,4309.0,13,/Date(1643272440000)/,473,594,0,0,249,298,0,2022-01-27 03:34:00
4312.25,140,147,4312.5,4310.0,4310.75,13,/Date(1643272500000)/,335,396,0,0,195,249,0,2022-01-27 03:35:00
4316.5,195,236,4316.75,4311.0,4312.0,13,/Date(1643272560000)/,414,556,0,0,219,320,0,2022-01-27 03:36:00
4317.75,181,216,4318.0,4315.0,4316.5,13,/Date(1643272620000)/,389,492,0,0,208,276,0,2022-01-27 03:37:00
4314.5,186,203,4317.75,4314.25,4317.5,13,/Date(1643272680000)/,301,345,0,0,115,142,0,2022-01-27 03:38:00
4315.0,170,186,4315.5,4311.0,4314.75,13,/Date(1643272740000)/,329,352,0,0,159,166,0,2022-01-27 03:39:00
4312.25,157,197,4315.5,4312.25,4315.5,13,/Date(1643272800000)/,227,271,0,0,70,74,0,2022-01-27 03:40:00
4314.75,98,102,4315.0,4312.0,4312.25,13,/Date(1643272860000)/,224,240,0,0,126,138,0,2022-01-27 03:41:00
4316.0,117,135,4316.5,4314.0,4314.75,13,/Date(1643272920000)/,262,322,0,0,145,187,0,2022-01-27 03:42:00
4316.25,143,149,4318.0,4315.5,4316.0,13,/Date(1643272980000)/,330,352,0,0,187,203,0,2022-01-27 03:43:00
4317.75,94,97,4318.5,4316.5,4316.5,13,/Date(1643273040000)/,190,208,0,0,96,111,0,2022-01-27 03:44:00
4317.5,118,139,4318.0,4316.25,4317.75,13,/Date(1643273100000)/,220,263,0,0,102,124,0,2022-01-27 03:45:00
4318.25,150,164,4318.25,4315.5,4317.5,13,/Date(1643273160000)/,333,369,0,0,183,205,0,2022-01-27 03:46:00
4318.0,285,405,4320.0,4317.25,4318.0,13,/Date(1643273220000)/,515,688,0,0,230,283,0,2022-01-27 03:47:00
4323.25,267,312,4324.0,4318.0,4318.0,13,/Date(1643273280000)/,625,793,0,0,358,481,0,2022-01-27 03:48:00
4323.0,313,352,4326.25,4322.25,4323.0,13,/Date(1643273340000)/,640,748,0,0,327,396,0,2022-01-27 03:49:00
4319.75,199,220,4322.75,4319.75,4322.75,13,/Date(1643273400000)/,345,405,0,0,146,185,0,2022-01-27 03:50:00
4322.25,127,162,4322.75,4319.25,4319.75,13,/Date(1643273460000)/,271,314,0,0,144,152,0,2022-01-27 03:51:00
4322.5,163,181,4324.0,4322.0,4322.25,13,/Date(1643273520000)/,323,367,0,0,160,186,0,2022-01-27 03:52:00
4321.25,123,147,4323.0,4320.75,4322.5,13,/Date(1643273580000)/,217,249,0,0,94,102,0,2022-01-27 03:53:00
4324.25,88,103,4324.25,4321.25,4321.25,13,/Date(1643273640000)/,291,350,0,0,203,247,0,2022-01-27 03:54:00
4324.5,80,89,4325.0,4323.75,4324.25,13,/Date(1643273700000)/,170,189,0,0,90,100,0,2022-01-27 03:55:00
4325.5,208,237,4327.75,4324.75,4324.75,13,/Date(1643273760000)/,450,503,0,0,242,266,0,2022-01-27 03:56:00
4328.5,185,240,4328.75,4324.5,4325.5,13,/Date(1643273820000)/,499,659,0,0,314,419,0,2022-01-27 03:57:00
4328.25,346,461,4329.25,4326.75,4328.25,13,/Date(1643273880000)/,627,780,0,0,281,319,0,2022-01-27 03:58:00
4328.5,317,354,4330.0,4326.75,4328.0,13,/Date(1643273940000)/,635,888,0,0,318,534,0,2022-01-27 03:59:00
4329.0,122,147,4329.5,4327.25,4328.25,13,/Date(1643274000000)/,375,451,0,0,253,304,0,2022-01-27 04:00:00
4328.25,593,1029,4329.75,4324.5,4328.75,13,/Date(1643274060000)/,1031,1560,0,0,438,531,0,2022-01-27 04:01:00
4334.5,512,643,4334.5,4328.0,4328.0,13,/Date(1643274120000)/,1276,1779,0,0,764,1136,0,2022-01-27 04:02:00
4338.25,377,480,4338.5,4333.75,4334.75,13,/Date(1643274180000)/,908,1229,0,0,531,749,0,2022-01-27 04:03:00
4338.25,433,556,4339.75,4337.25,4338.0,13,/Date(1643274240000)/,839,1086,0,0,406,530,0,2022-01-27 04:04:00
4331.25,812,1129,4338.0,4331.25,4338.0,13,/Date(1643274300000)/,1100,1548,0,0,288,419,0,2022-01-27 04:05:00
4332.5,314,378,4332.75,4329.75,4331.5,13,/Date(1643274360000)/,650,939,0,0,336,561,0,2022-01-27 04:06:00
4331.25,364,448,4332.75,4328.75,4332.75,13,/Date(1643274420000)/,661,872,0,0,297,424,0,2022-01-27 04:07:00
4331.0,330,391,4333.0,4330.25,4331.5,13,/Date(1643274480000)/,585,692,0,0,255,301,0,2022-01-27 04:08:00
4326.5,252,313,4331.0,4326.25,4331.0,13,/Date(1643274540000)/,446,539,0,0,194,226,0,2022-01-27 04:09:00
4325.75,276,346,4328.0,4325.5,4327.0,13,/Date(1643274600000)/,528,655,0,0,252,309,0,2022-01-27 04:10:00
4325.0,267,330,4328.0,4323.5,4325.5,13,/Date(1643274660000)/,508,616,0,0,241,286,0,2022-01-27 04:11:00
4325.25,368,470,4326.0,4323.0,4324.75,13,/Date(1643274720000)/,685,839,0,0,317,369,0,2022-01-27 04:12:00
4331.0,274,365,4331.25,4325.75,4325.75,13,/Date(1643274780000)/,596,743,0,0,322,378,0,2022-01-27 04:13:00
4334.25,255,372,4334.5,4331.0,4331.0,13,/Date(1643274840000)/,555,783,0,0,300,411,0,2022-01-27 04:14:00
4333.25,315,452,4335.0,4332.0,4334.5,13,/Date(1643274900000)/,604,852,0,0,289,400,0,2022-01-27 04:15:00
4335.75,267,334,4336.0,4333.25,4333.25,13,/Date(1643274960000)/,691,849,0,0,424,515,0,2022-01-27 04:16:00
4331.0,244,317,4335.5,4330.5,4335.5,13,/Date(1643275020000)/,360,441,0,0,116,124,0,2022-01-27 04:17:00
4330.25,104,122,4332.5,4329.25,4331.0,13,/Date(1643275080000)/,211,247,0,0,107,125,0,2022-01-27 04:18:00
4333.5,138,149,4333.75,4329.25,4330.0,13,/Date(1643275140000)/,292,316,0,0,154,167,0,2022-01-27 04:19:00
4334.75,204,295,4335.25,4331.5,4333.5,13,/Date(1643275200000)/,389,521,0,0,185,226,0,2022-01-27 04:20:00
4332.25,184,231,4335.0,4331.5,4334.5,13,/Date(1643275260000)/,310,365,0,0,126,134,0,2022-01-27 04:21:00
4331.0,171,179,4332.5,4329.5,4332.5,13,/Date(1643275320000)/,275,295,0,0,104,116,0,2022-01-27 04:22:00
4333.75,159,169,4334.5,4331.25,4331.25,13,/Date(1643275380000)/,359,439,0,0,200,270,0,2022-01-27 04:23:00
4337.0,198,257,4337.25,4333.75,4334.0,13,/Date(1643275440000)/,451,560,0,0,253,303,0,2022-01-27 04:24:00
4341.0,316,419,4341.5,4336.25,4336.75,13,/Date(1643275500000)/,791,1067,0,0,475,648,0,2022-01-27 04:25:00
4339.75,197,216,4340.75,4338.75,4340.75,13,/Date(1643275560000)/,333,384,0,0,136,168,0,2022-01-27 04:26:00
4341.5,117,121,4342.25,4338.75,4339.5,13,/Date(1643275620000)/,323,362,0,0,206,241,0,2022-01-27 04:27:00
4343.0,164,222,4343.0,4340.75,4341.75,13,/Date(1643275680000)/,381,474,0,0,217,252,0,2022-01-27 04:28:00
4344.75,275,395,4345.75,4342.5,4343.0,13,/Date(1643275740000)/,636,977,0,0,361,582,0,2022-01-27 04:29:00
4342.0,482,618,4345.25,4341.75,4345.0,13,/Date(1643275800000)/,775,1116,0,0,293,498,0,2022-01-27 04:30:00
4339.25,371,465,4342.5,4339.0,4342.25,13,/Date(1643275860000)/,578,714,0,0,207,249,0,2022-01-27 04:31:00
4336.0,450,555,4340.0,4335.75,4339.25,13,/Date(1643275920000)/,711,894,0,0,261,339,0,2022-01-27 04:32:00
4338.5,222,246,4339.0,4336.0,4336.25,13,/Date(1643275980000)/,517,665,0,0,295,419,0,2022-01-27 04:33:00
4338.25,180,200,4338.75,4337.0,4338.5,13,/Date(1643276040000)/,337,417,0,0,157,217,0,2022-01-27 04:34:00
4335.75,208,226,4338.5,4335.75,4338.5,13,/Date(1643276100000)/,337,415,0,0,129,189,0,2022-01-27 04:35:00
4338.0,194,242,4338.25,4334.5,4336.0,13,/Date(1643276160000)/,376,473,0,0,182,231,0,2022-01-27 04:36:00
4335.0,359,432,4339.0,4334.25,4338.25,13,/Date(1643276220000)/,581,759,0,0,222,327,0,2022-01-27 04:37:00
4338.25,142,168,4338.5,4335.25,4335.25,13,/Date(1643276280000)/,354,433,0,0,212,265,0,2022-01-27 04:38:00
4337.25,163,171,4338.5,4336.25,4338.0,13,/Date(1643276340000)/,345,427,0,0,182,256,0,2022-01-27 04:39:00
4337.5,176,205,4338.75,4335.75,4337.5,13,/Date(1643276400000)/,378,438,0,0,202,233,0,2022-01-27 04:40:00
4336.75,220,364,4338.25,4335.0,4337.25,13,/Date(1643276460000)/,373,528,0,0,153,164,0,2022-01-27 04:41:00
4337.5,208,241,4337.75,4335.75,4336.5,13,/Date(1643276520000)/,293,336,0,0,85,95,0,2022-01-27 04:42:00
4340.25,100,111,4340.75,4337.25,4337.5,13,/Date(1643276580000)/,295,362,0,0,195,251,0,2022-01-27 04:43:00
4343.0,186,233,4344.25,4339.75,4340.5,13,/Date(1643276640000)/,452,647,0,0,266,414,0,2022-01-27 04:44:00
4344.25,164,186,4345.75,4342.5,4343.25,13,/Date(1643276700000)/,451,587,0,0,287,401,0,2022-01-27 04:45:00
4346.0,196,270,4346.0,4342.0,4344.5,13,/Date(1643276760000)/,390,524,0,0,194,254,0,2022-01-27 04:46:00
4348.0,292,372,4348.25,4345.75,4346.25,13,/Date(1643276820000)/,655,864,0,0,363,492,0,2022-01-27 04:47:00
4346.5,237,289,4348.75,4346.5,4348.0,13,/Date(1643276880000)/,441,571,0,0,204,282,0,2022-01-27 04:48:00
4345.75,124,130,4347.0,4345.0,4346.75,13,/Date(1643276940000)/,255,289,0,0,131,159,0,2022-01-27 04:49:00
4346.5,149,164,4347.5,4345.75,4346.0,13,/Date(1643277000000)/,262,330,0,0,113,166,0,2022-01-27 04:50:00
4347.5,193,209,4347.75,4345.0,4346.25,13,/Date(1643277060000)/,420,488,0,0,227,279,0,2022-01-27 04:51:00
4349.25,278,385,4349.75,4347.75,4347.75,13,/Date(1643277120000)/,600,819,0,0,322,434,0,2022-01-27 04:52:00
4350.25,247,304,4351.75,4349.25,4349.25,13,/Date(1643277180000)/,563,828,0,0,316,524,0,2022-01-27 04:53:00
4351.75,194,254,4352.0,4349.0,4350.0,13,/Date(1643277240000)/,406,493,0,0,212,239,0,2022-01-27 04:54:00
4348.25,281,334,4351.75,4348.25,4351.75,13,/Date(1643277300000)/,393,452,0,0,112,118,0,2022-01-27 04:55:00
4349.25,278,423,4351.5,4348.25,4348.5,13,/Date(1643277360000)/,500,702,0,0,222,279,0,2022-01-27 04:56:00
4349.0,352,482,4350.5,4348.75,4349.25,13,/Date(1643277420000)/,625,822,0,0,273,340,0,2022-01-27 04:57:00
4347.75,175,227,4349.5,4347.5,4349.25,13,/Date(1643277480000)/,300,408,0,0,125,181,0,2022-01-27 04:58:00
4348.75,183,214,4348.75,4346.25,4348.0,13,/Date(1643277540000)/,371,446,0,0,188,232,0,2022-01-27 04:59:00
4347.0,120,144,4349.25,4346.5,4348.5,13,/Date(1643277600000)/,239,285,0,0,119,141,0,2022-01-27 05:00:00
4346.5,163,184,4348.5,4346.5,4346.75,13,/Date(1643277660000)/,258,290,0,0,95,106,0,2022-01-27 05:01:00
4347.75,143,210,4348.25,4345.5,4346.5,13,/Date(1643277720000)/,286,374,0,0,143,164,0,2022-01-27 05:02:00
4347.0,213,241,4347.75,4346.25,4347.5,13,/Date(1643277780000)/,310,411,0,0,97,170,0,2022-01-27 05:03:00
4349.75,96,103,4350.0,4347.0,4347.0,13,/Date(1643277840000)/,251,284,0,0,155,181,0,2022-01-27 05:04:00
4353.5,186,210,4354.0,4349.5,4349.75,13,/Date(1643277900000)/,531,696,0,0,345,486,0,2022-01-27 05:05:00
4352.5,176,287,4353.75,4352.0,4353.25,13,/Date(1643277960000)/,342,472,0,0,166,185,0,2022-01-27 05:06:00
4354.0,124,170,4355.5,4352.5,4352.75,13,/Date(1643278020000)/,366,525,0,0,242,355,0,2022-01-27 05:07:00
4353.25,136,163,4354.25,4352.5,4353.75,13,/Date(1643278080000)/,258,315,0,0,122,152,0,2022-01-27 05:08:00
4351.75,222,310,4353.25,4350.5,4353.25,13,/Date(1643278140000)/,367,548,0,0,145,238,0,2022-01-27 05:09:00
4350.5,113,144,4352.0,4350.0,4352.0,13,/Date(1643278200000)/,213,270,0,0,100,126,0,2022-01-27 05:10:00
4350.5,152,189,4352.0,4350.0,4350.5,13,/Date(1643278260000)/,309,418,0,0,157,229,0,2022-01-27 05:11:00
4348.75,144,161,4351.5,4348.25,4350.5,13,/Date(1643278320000)/,265,296,0,0,121,135,0,2022-01-27 05:12:00
4343.25,611,824,4348.75,4342.5,4348.5,13,/Date(1643278380000)/,941,1253,0,0,330,429,0,2022-01-27 05:13:00
4343.25,313,354,4345.0,4341.75,4343.0,13,/Date(1643278440000)/,653,757,0,0,340,403,0,2022-01-27 05:14:00
4342.5,338,406,4344.25,4341.0,4343.5,13,/Date(1643278500000)/,613,812,0,0,275,406,0,2022-01-27 05:15:00
4344.0,152,167,4345.75,4342.0,4343.0,13,/Date(1643278560000)/,375,448,0,0,223,281,0,2022-01-27 05:16:00
4344.5,143,183,4345.25,4343.25,4344.25,13,/Date(1643278620000)/,308,395,0,0,165,212,0,2022-01-27 05:17:00
4344.0,233,350,4345.25,4343.0,4345.0,13,/Date(1643278680000)/,380,542,0,0,147,192,0,2022-01-27 05:18:00
4343.5,91,100,4344.75,4343.5,4344.0,13,/Date(1643278740000)/,129,141,0,0,38,41,0,2022-01-27 05:19:00
4339.0,315,375,4343.5,4338.5,4343.5,13,/Date(1643278800000)/,489,580,0,0,174,205,0,2022-01-27 05:20:00
4338.75,250,353,4342.0,4338.25,4339.0,13,/Date(1643278860000)/,506,691,0,0,256,338,0,2022-01-27 05:21:00
4340.0,132,165,4340.0,4338.5,4338.75,13,/Date(1643278920000)/,253,297,0,0,121,132,0,2022-01-27 05:22:00
4339.25,168,221,4341.75,4339.25,4340.0,13,/Date(1643278980000)/,270,355,0,0,102,134,0,2022-01-27 05:23:00
4344.0,174,201,4344.5,4339.25,4339.25,13,/Date(1643279040000)/,376,483,0,0,202,282,0,2022-01-27 05:24:00
4345.0,142,213,4345.75,4343.5,4343.75,13,/Date(1643279100000)/,343,499,0,0,201,286,0,2022-01-27 05:25:00
4344.25,88,95,4345.25,4343.5,4345.0,13,/Date(1643279160000)/,170,203,0,0,82,108,0,2022-01-27 05:26:00
4347.75,173,210,4348.25,4344.25,4344.75,13,/Date(1643279220000)/,439,600,0,0,266,390,0,2022-01-27 05:27:00
4346.0,140,187,4347.75,4346.0,4347.75,13,/Date(1643279280000)/,232,290,0,0,92,103,0,2022-01-27 05:28:00
4347.75,194,238,4349.0,4345.25,4345.75,13,/Date(1643279340000)/,417,552,0,0,223,314,0,2022-01-27 05:29:00
4345.0,193,217,4347.5,4344.0,4347.5,13,/Date(1643279400000)/,336,391,0,0,143,174,0,2022-01-27 05:30:00
4342.25,302,331,4345.5,4341.75,4345.25,13,/Date(1643279460000)/,593,736,0,0,291,405,0,2022-01-27 05:31:00
4343.0,94,126,4343.75,4341.75,4342.0,13,/Date(1643279520000)/,224,285,0,0,130,159,0,2022-01-27 05:32:00
4346.25,114,170,4347.0,4342.5,4343.0,13,/Date(1643279580000)/,338,417,0,0,224,247,0,2022-01-27 05:33:00
4343.25,204,240,4346.75,4342.75,4346.25,13,/Date(1643279640000)/,414,538,0,0,210,298,0,2022-01-27 05:34:00
4345.75,89,109,4346.0,4343.0,4343.0,13,/Date(1643279700000)/,211,249,0,0,122,140,0,2022-01-27 05:35:00
4344.0,158,185,4347.25,4343.75,4345.75,13,/Date(1643279760000)/,274,318,0,0,116,133,0,2022-01-27 05:36:00
4344.5,77,83,4345.0,4344.0,4344.0,13,/Date(1643279820000)/,138,151,0,0,61,68,0,2022-01-27 05:37:00
4346.25,99,101,4347.0,4344.25,4344.5,13,/Date(1643279880000)/,236,295,0,0,137,194,0,2022-01-27 05:38:00
4346.75,79,85,4346.75,4344.25,4346.0,13,/Date(1643279940000)/,159,176,0,0,80,91,0,2022-01-27 05:39:00
4347.0,52,52,4347.75,4346.25,4346.5,13,/Date(1643280000000)/,112,124,0,0,60,72,0,2022-01-27 05:40:00
4345.75,120,144,4347.25,4345.5,4347.0,13,/Date(1643280060000)/,224,271,0,0,104,127,0,2022-01-27 05:41:00
4343.5,143,157,4346.0,4343.25,4345.75,13,/Date(1643280120000)/,245,264,0,0,102,107,0,2022-01-27 05:42:00
4342.5,105,143,4344.75,4342.0,4343.75,13,/Date(1643280180000)/,197,242,0,0,92,99,0,2022-01-27 05:43:00
4340.25,175,204,4342.75,4339.75,4342.75,13,/Date(1643280240000)/,305,341,0,0,130,137,0,2022-01-27 05:44:00
4341.5,110,133,4341.75,4339.75,4340.25,13,/Date(1643280300000)/,199,229,0,0,89,96,0,2022-01-27 05:45:00
4342.0,143,183,4342.25,4341.0,4341.75,13,/Date(1643280360000)/,234,281,0,0,91,98,0,2022-01-27 05:46:00
4344.5,127,149,4345.25,4342.25,4342.25,13,/Date(1643280420000)/,256,296,0,0,129,147,0,2022-01-27 05:47:00
4344.25,54,65,4344.5,4342.75,4344.5,13,/Date(1643280480000)/,129,141,0,0,75,76,0,2022-01-27 05:48:00
4338.5,281,360,4344.25,4338.0,4344.25,13,/Date(1643280540000)/,400,571,0,0,119,211,0,2022-01-27 05:49:00
4336.25,509,747,4339.25,4336.0,4338.5,13,/Date(1643280600000)/,753,1101,0,0,244,354,0,2022-01-27 05:50:00
4332.5,548,759,4337.0,4331.25,4336.25,13,/Date(1643280660000)/,967,1265,0,0,419,506,0,2022-01-27 05:51:00
4329.0,323,424,4333.0,4329.0,4332.75,13,/Date(1643280720000)/,558,697,0,0,235,273,0,2022-01-27 05:52:00
4327.25,536,693,4331.5,4327.25,4329.25,13,/Date(1643280780000)/,924,1229,0,0,388,536,0,2022-01-27 05:53:00
4330.75,262,303,4331.25,4326.75,4327.25,13,/Date(1643280840000)/,564,696,0,0,302,393,0,2022-01-27 05:54:00
4328.0,143,163,4331.25,4327.25,4330.75,13,/Date(1643280900000)/,260,289,0,0,117,126,0,2022-01-27 05:55:00
4323.25,642,837,4328.5,4323.0,4327.75,13,/Date(1643280960000)/,1050,1321,0,0,408,484,0,2022-01-27 05:56:00
4323.25,188,225,4325.25,4323.25,4323.5,13,/Date(1643281020000)/,469,542,0,0,281,317,0,2022-01-27 05:57:00
4322.5,253,355,4325.0,4322.0,4323.0,13,/Date(1643281080000)/,444,612,0,0,191,257,0,2022-01-27 05:58:00
4322.25,300,601,4324.75,4321.25,4322.25,13,/Date(1643281140000)/,564,899,0,0,264,298,0,2022-01-27 05:59:00
4325.5,266,347,4325.75,4322.25,4322.25,13,/Date(1643281200000)/,620,796,0,0,354,449,0,2022-01-27 06:00:00
4329.75,309,399,4330.0,4325.25,4325.5,13,/Date(1643281260000)/,745,940,0,0,436,541,0,2022-01-27 06:01:00
4325.75,231,264,4330.5,4325.25,4330.0,13,/Date(1643281320000)/,484,576,0,0,253,312,0,2022-01-27 06:02:00
4330.0,255,324,4330.75,4325.75,4325.75,13,/Date(1643281380000)/,562,716,0,0,307,392,0,2022-01-27 06:03:00
4332.0,295,421,4333.25,4328.5,4329.75,13,/Date(1643281440000)/,526,715,0,0,231,294,0,2022-01-27 06:04:00
4334.5,224,256,4335.5,4331.5,4331.75,13,/Date(1643281500000)/,553,667,0,0,329,411,0,2022-01-27 06:05:00
4336.25,237,295,4338.5,4333.75,4334.25,13,/Date(1643281560000)/,518,621,0,0,281,326,0,2022-01-27 06:06:00
4335.75,161,208,4336.25,4334.75,4336.25,13,/Date(1643281620000)/,264,330,0,0,103,122,0,2022-01-27 06:07:00
4336.0,134,145,4337.0,4334.75,4335.5,13,/Date(1643281680000)/,291,316,0,0,157,171,0,2022-01-27 06:08:00
4336.5,113,149,4337.75,4335.75,4336.25,13,/Date(1643281740000)/,191,230,0,0,78,81,0,2022-01-27 06:09:00
4333.5,214,235,4336.75,4332.75,4336.75,13,/Date(1643281800000)/,378,436,0,0,164,201,0,2022-01-27 06:10:00
4336.25,198,256,4338.5,4333.0,4333.75,13,/Date(1643281860000)/,488,601,0,0,290,345,0,2022-01-27 06:11:00
4337.5,113,140,4338.0,4335.5,4336.0,13,/Date(1643281920000)/,216,294,0,0,103,154,0,2022-01-27 06:12:00
4338.25,128,166,4339.5,4337.5,4337.5,13,/Date(1643281980000)/,261,364,0,0,133,198,0,2022-01-27 06:13:00
4336.25,119,124,4338.75,4336.0,4338.75,13,/Date(1643282040000)/,217,225,0,0,98,101,0,2022-01-27 06:14:00
4339.5,140,205,4340.5,4336.5,4336.5,13,/Date(1643282100000)/,360,456,0,0,220,251,0,2022-01-27 06:15:00
4342.25,204,264,4343.0,4339.5,4339.5,13,/Date(1643282160000)/,448,606,0,0,244,342,0,2022-01-27 06:16:00
4342.0,128,183,4343.25,4341.25,4342.25,13,/Date(1643282220000)/,258,323,0,0,130,140,0,2022-01-27 06:17:00
4339.5,113,115,4342.25,4339.25,4342.0,13,/Date(1643282280000)/,199,225,0,0,86,110,0,2022-01-27 06:18:00
4340.0,96,105,4340.5,4339.0,4339.5,13,/Date(1643282340000)/,206,246,0,0,110,141,0,2022-01-27 06:19:00
4338.25,76,127,4340.0,4338.0,4339.75,13,/Date(1643282400000)/,124,191,0,0,48,64,0,2022-01-27 06:20:00
4336.75,188,242,4338.25,4335.5,4338.0,13,/Date(1643282460000)/,321,427,0,0,133,185,0,2022-01-27 06:21:00
4337.0,83,87,4338.25,4336.5,4336.75,13,/Date(1643282520000)/,163,180,0,0,80,93,0,2022-01-27 06:22:00
4334.75,211,338,4337.25,4334.0,4337.0,13,/Date(1643282580000)/,280,409,0,0,69,71,0,2022-01-27 06:23:00
4335.5,130,158,4336.25,4334.5,4334.5,13,/Date(1643282640000)/,249,309,0,0,119,151,0,2022-01-27 06:24:00
4338.75,112,115,4338.75,4335.0,4335.5,13,/Date(1643282700000)/,270,362,0,0,158,247,0,2022-01-27 06:25:00
4339.0,131,150,4340.0,4338.5,4338.75,13,/Date(1643282760000)/,265,290,0,0,134,140,0,2022-01-27 06:26:00
4340.75,113,192,4342.25,4338.75,4339.25,13,/Date(1643282820000)/,270,423,0,0,157,231,0,2022-01-27 06:27:00
4342.0,143,175,4343.75,4340.75,4341.0,13,/Date(1643282880000)/,346,440,0,0,203,265,0,2022-01-27 06:28:00
4343.75,126,163,4343.75,4341.75,4342.0,13,/Date(1643282940000)/,222,263,0,0,96,100,0,2022-01-27 06:29:00
4347.0,266,346,4348.75,4343.25,4343.5,13,/Date(1643283000000)/,752,991,0,0,486,645,0,2022-01-27 06:30:00
4344.0,261,314,4348.0,4343.5,4347.0,13,/Date(1643283060000)/,436,499,0,0,175,185,0,2022-01-27 06:31:00
4346.0,100,126,4347.25,4344.0,4344.25,13,/Date(1643283120000)/,268,344,0,0,168,218,0,2022-01-27 06:32:00
4348.25,108,126,4348.75,4345.5,4346.0,13,/Date(1643283180000)/,295,362,0,0,187,236,0,2022-01-27 06:33:00
4345.75,217,279,4348.25,4344.75,4348.0,13,/Date(1643283240000)/,347,452,0,0,130,173,0,2022-01-27 06:34:00
4345.0,160,230,4346.0,4343.25,4346.0,13,/Date(1643283300000)/,412,502,0,0,252,272,0,2022-01-27 06:35:00
4345.25,150,290,4345.75,4344.5,4344.75,13,/Date(1643283360000)/,324,535,0,0,174,245,0,2022-01-27 06:36:00
4346.75,127,174,4347.75,4345.0,4345.0,13,/Date(1643283420000)/,288,395,0,0,161,221,0,2022-01-27 06:37:00
4345.5,107,130,4347.75,4345.0,4346.75,13,/Date(1643283480000)/,207,253,0,0,100,123,0,2022-01-27 06:38:00
4341.25,451,649,4345.5,4341.0,4345.25,13,/Date(1643283540000)/,779,1148,0,0,328,499,0,2022-01-27 06:39:00
4338.0,467,659,4341.5,4336.5,4341.5,13,/Date(1643283600000)/,829,1103,0,0,362,444,0,2022-01-27 06:40:00
4340.0,237,329,4340.75,4336.75,4338.25,13,/Date(1643283660000)/,478,622,0,0,241,293,0,2022-01-27 06:41:00
4339.25,79,97,4340.25,4338.75,4340.0,13,/Date(1643283720000)/,159,199,0,0,80,102,0,2022-01-27 06:42:00
4340.75,130,154,4340.75,4338.0,4339.25,13,/Date(1643283780000)/,234,265,0,0,104,111,0,2022-01-27 06:43:00
4342.75,152,169,4343.25,4340.5,4340.75,13,/Date(1643283840000)/,376,434,0,0,224,265,0,2022-01-27 06:44:00
4340.5,130,160,4343.0,4340.0,4343.0,13,/Date(1643283900000)/,222,275,0,0,92,115,0,2022-01-27 06:45:00
4335.75,234,256,4340.75,4335.5,4340.75,13,/Date(1643283960000)/,371,419,0,0,137,163,0,2022-01-27 06:46:00
4337.25,260,307,4337.5,4334.5,4335.5,13,/Date(1643284020000)/,526,637,0,0,266,330,0,2022-01-27 06:47:00
4339.75,146,151,4340.25,4337.0,4337.25,13,/Date(1643284080000)/,329,370,0,0,183,219,0,2022-01-27 06:48:00
4342.5,169,176,4343.25,4339.0,4339.75,13,/Date(1643284140000)/,404,472,0,0,235,296,0,2022-01-27 06:49:00
4341.5,82,101,4342.5,4340.75,4342.25,13,/Date(1643284200000)/,154,185,0,0,72,84,0,2022-01-27 06:50:00
4344.75,151,158,4345.25,4341.25,4341.5,13,/Date(1643284260000)/,392,489,0,0,241,331,0,2022-01-27 06:51:00
4346.5,172,218,4347.5,4344.75,4344.75,13,/Date(1643284320000)/,385,490,0,0,213,272,0,2022-01-27 06:52:00
4348.0,189,247,4348.75,4346.0,4346.5,13,/Date(1643284380000)/,480,631,0,0,291,384,0,2022-01-27 06:53:00
4345.25,217,358,4348.25,4344.75,4348.25,13,/Date(1643284440000)/,312,461,0,0,95,103,0,2022-01-27 06:54:00
4346.0,161,207,4346.75,4345.25,4345.25,13,/Date(1643284500000)/,312,385,0,0,151,178,0,2022-01-27 06:55:00
4343.5,224,263,4346.0,4342.5,4346.0,13,/Date(1643284560000)/,331,384,0,0,107,121,0,2022-01-27 06:56:00
4344.5,108,126,4345.0,4342.0,4343.5,13,/Date(1643284620000)/,262,286,0,0,154,160,0,2022-01-27 06:57:00
4348.75,179,234,4349.75,4344.0,4344.25,13,/Date(1643284680000)/,440,585,0,0,261,351,0,2022-01-27 06:58:00
4350.75,276,342,4352.0,4348.5,4348.5,13,/Date(1643284740000)/,610,887,0,0,334,545,0,2022-01-27 06:59:00
4351.25,150,172,4352.0,4350.0,4351.0,13,/Date(1643284800000)/,292,323,0,0,142,151,0,2022-01-27 07:00:00
4349.0,340,418,4352.5,4348.5,4351.25,13,/Date(1643284860000)/,584,706,0,0,244,288,0,2022-01-27 07:01:00
4349.0,288,337,4351.5,4347.75,4349.0,13,/Date(1643284920000)/,526,628,0,0,238,291,0,2022-01-27 07:02:00
4349.0,385,472,4350.0,4346.25,4349.0,13,/Date(1643284980000)/,723,926,0,0,338,454,0,2022-01-27 07:03:00
4346.25,214,245,4349.75,4346.25,4349.25,13,/Date(1643285040000)/,342,400,0,0,128,155,0,2022-01-27 07:04:00
4349.25,140,160,4349.5,4346.25,4346.5,13,/Date(1643285100000)/,372,433,0,0,232,273,0,2022-01-27 07:05:00
4345.75,288,415,4349.25,4344.5,4349.25,13,/Date(1643285160000)/,477,641,0,0,189,226,0,2022-01-27 07:06:00
4345.0,170,182,4346.0,4343.5,4345.75,13,/Date(1643285220000)/,321,383,0,0,151,201,0,2022-01-27 07:07:00
4345.0,176,199,4346.75,4345.0,4345.0,13,/Date(1643285280000)/,309,356,0,0,133,157,0,2022-01-27 07:08:00
4345.5,120,138,4345.75,4343.5,4345.0,13,/Date(1643285340000)/,291,340,0,0,171,202,0,2022-01-27 07:09:00
4348.25,106,108,4348.25,4344.0,4345.5,13,/Date(1643285400000)/,440,482,0,0,334,374,0,2022-01-27 07:10:00
4351.75,248,312,4351.75,4347.25,4348.0,13,/Date(1643285460000)/,550,668,0,0,302,356,0,2022-01-27 07:11:00
4354.25,314,373,4354.75,4351.25,4351.75,13,/Date(1643285520000)/,665,821,0,0,351,448,0,2022-01-27 07:12:00
4357.25,320,419,4357.25,4353.75,4354.25,13,/Date(1643285580000)/,831,1091,0,0,511,672,0,2022-01-27 07:13:00
4357.5,254,322,4357.75,4356.0,4357.25,13,/Date(1643285640000)/,525,640,0,0,271,318,0,2022-01-27 07:14:00
4356.0,206,230,4358.0,4356.0,4357.75,13,/Date(1643285700000)/,419,528,0,0,213,298,0,2022-01-27 07:15:00
4356.25,271,310,4358.75,4355.5,4356.0,13,/Date(1643285760000)/,520,608,0,0,249,298,0,2022-01-27 07:16:00
4352.0,392,447,4356.5,4352.0,4356.5,13,/Date(1643285820000)/,639,743,0,0,247,296,0,2022-01-27 07:17:00
4351.5,262,338,4354.25,4350.5,4352.25,13,/Date(1643285880000)/,522,792,0,0,260,454,0,2022-01-27 07:18:00
4345.75,573,693,4351.75,4345.5,4351.5,13,/Date(1643285940000)/,847,1060,0,0,274,367,0,2022-01-27 07:19:00
4344.0,442,549,4347.5,4343.75,4345.75,13,/Date(1643286000000)/,736,1076,0,0,294,527,0,2022-01-27 07:20:00
4342.75,385,518,4346.5,4342.75,4344.0,13,/Date(1643286060000)/,743,1074,0,0,358,556,0,2022-01-27 07:21:00
4345.25,293,399,4346.0,4343.0,4343.0,13,/Date(1643286120000)/,624,809,0,0,331,410,0,2022-01-27 07:22:00
4340.25,507,654,4345.25,4339.75,4345.25,13,/Date(1643286180000)/,745,960,0,0,238,306,0,2022-01-27 07:23:00
4338.25,672,906,4340.75,4336.5,4340.25,13,/Date(1643286240000)/,1163,1662,0,0,491,756,0,2022-01-27 07:24:00
4336.25,402,579,4339.25,4335.75,4338.0,13,/Date(1643286300000)/,699,1030,0,0,297,451,0,2022-01-27 07:25:00
4337.25,223,280,4338.5,4336.0,4336.0,13,/Date(1643286360000)/,517,691,0,0,294,411,0,2022-01-27 07:26:00
4340.5,272,340,4340.5,4335.75,4337.5,13,/Date(1643286420000)/,574,715,0,0,302,375,0,2022-01-27 07:27:00
4338.5,452,593,4342.25,4337.25,4340.25,13,/Date(1643286480000)/,894,1139,0,0,442,546,0,2022-01-27 07:28:00
4342.75,151,204,4343.0,4338.0,4338.75,13,/Date(1643286540000)/,408,566,0,0,257,362,0,2022-01-27 07:29:00
4340.5,320,376,4343.75,4340.5,4342.75,13,/Date(1643286600000)/,652,832,0,0,332,456,0,2022-01-27 07:30:00
4341.0,277,386,4341.75,4340.0,4340.25,13,/Date(1643286660000)/,529,757,0,0,252,371,0,2022-01-27 07:31:00
4339.25,354,468,4344.5,4339.25,4341.25,13,/Date(1643286720000)/,611,819,0,0,257,351,0,2022-01-27 07:32:00
4338.0,245,325,4340.5,4337.75,4339.25,13,/Date(1643286780000)/,451,613,0,0,206,288,0,2022-01-27 07:33:00
4336.5,394,495,4338.0,4334.75,4338.0,13,/Date(1643286840000)/,633,803,0,0,239,308,0,2022-01-27 07:34:00
4332.25,700,988,4337.25,4331.5,4336.25,13,/Date(1643286900000)/,1108,1597,0,0,408,609,0,2022-01-27 07:35:00
4333.75,343,455,4335.25,4331.5,4332.0,13,/Date(1643286960000)/,720,964,0,0,377,509,0,2022-01-27 07:36:00
4338.0,173,203,4338.25,4333.0,4333.75,13,/Date(1643287020000)/,434,521,0,0,261,318,0,2022-01-27 07:37:00
4342.75,183,221,4343.0,4337.75,4338.0,13,/Date(1643287080000)/,525,678,0,0,342,457,0,2022-01-27 07:38:00
4341.25,248,339,4343.0,4339.75,4342.5,13,/Date(1643287140000)/,459,624,0,0,211,285,0,2022-01-27 07:39:00
4338.5,174,204,4341.5,4338.25,4341.25,13,/Date(1643287200000)/,293,357,0,0,119,153,0,2022-01-27 07:40:00
4338.25,149,176,4340.5,4337.5,4338.75,13,/Date(1643287260000)/,314,401,0,0,165,225,0,2022-01-27 07:41:00
4337.5,213,270,4341.75,4337.5,4338.25,13,/Date(1643287320000)/,425,563,0,0,212,293,0,2022-01-27 07:42:00
4337.5,209,288,4339.5,4336.75,4337.5,13,/Date(1643287380000)/,433,623,0,0,224,335,0,2022-01-27 07:43:00
4339.25,141,167,4340.75,4338.0,4338.0,13,/Date(1643287440000)/,368,507,0,0,227,340,0,2022-01-27 07:44:00
4337.25,278,334,4341.75,4336.75,4339.75,13,/Date(1643287500000)/,473,605,0,0,195,271,0,2022-01-27 07:45:00
4340.5,263,332,4343.5,4337.0,4337.5,13,/Date(1643287560000)/,730,971,0,0,467,639,0,2022-01-27 07:46:00
4344.25,238,307,4345.0,4339.5,4340.5,13,/Date(1643287620000)/,533,686,0,0,295,379,0,2022-01-27 07:47:00
4346.75,310,446,4346.75,4343.25,4344.25,13,/Date(1643287680000)/,630,847,0,0,320,401,0,2022-01-27 07:48:00
4347.0,264,322,4348.0,4345.5,4346.25,13,/Date(1643287740000)/,483,595,0,0,219,273,0,2022-01-27 07:49:00
4345.5,206,289,4347.25,4345.5,4346.75,13,/Date(1643287800000)/,345,456,0,0,139,167,0,2022-01-27 07:50:00
4347.75,150,235,4347.75,4344.0,4345.25,13,/Date(1643287860000)/,325,460,0,0,175,225,0,2022-01-27 07:51:00
4349.75,175,186,4350.5,4347.25,4347.75,13,/Date(1643287920000)/,460,538,0,0,285,352,0,2022-01-27 07:52:00
4352.5,214,266,4352.75,4349.75,4349.75,13,/Date(1643287980000)/,526,656,0,0,312,390,0,2022-01-27 07:53:00
4357.5,556,701,4358.25,4351.75,4352.5,13,/Date(1643288040000)/,1279,1588,0,0,723,887,0,2022-01-27 07:54:00
4355.25,368,428,4358.25,4354.5,4357.5,13,/Date(1643288100000)/,576,675,0,0,208,247,0,2022-01-27 07:55:00
4355.75,246,289,4358.5,4354.5,4355.0,13,/Date(1643288160000)/,534,653,0,0,288,364,0,2022-01-27 07:56:00
4354.75,225,266,4356.5,4353.5,4355.75,13,/Date(1643288220000)/,416,522,0,0,191,256,0,2022-01-27 07:57:00
4355.5,169,253,4355.5,4352.5,4354.75,13,/Date(1643288280000)/,362,521,0,0,193,268,0,2022-01-27 07:58:00
4354.0,171,207,4355.5,4354.0,4355.5,13,/Date(1643288340000)/,263,325,0,0,92,118,0,2022-01-27 07:59:00
4352.0,223,274,4354.0,4351.5,4353.75,13,/Date(1643288400000)/,367,437,0,0,144,163,0,2022-01-27 08:00:00
4350.75,538,600,4356.0,4350.0,4352.5,13,/Date(1643288460000)/,1021,1155,0,0,483,555,0,2022-01-27 08:01:00
4354.25,409,456,4356.0,4350.75,4350.75,13,/Date(1643288520000)/,935,1036,0,0,526,580,0,2022-01-27 08:02:00
4355.25,289,316,4357.5,4354.25,4354.25,13,/Date(1643288580000)/,573,631,0,0,284,315,0,2022-01-27 08:03:00
4359.25,396,475,4360.25,4355.0,4355.25,13,/Date(1643288640000)/,923,1139,0,0,527,664,0,2022-01-27 08:04:00
4353.0,600,712,4359.75,4352.75,4359.25,13,/Date(1643288700000)/,866,1001,0,0,266,289,0,2022-01-27 08:05:00
4360.5,296,320,4361.25,4353.25,4353.25,13,/Date(1643288760000)/,935,1117,0,0,639,797,0,2022-01-27 08:06:00
4362.0,505,604,4363.5,4360.25,4360.5,13,/Date(1643288820000)/,1117,1322,0,0,612,718,0,2022-01-27 08:07:00
4360.0,713,846,4363.5,4359.0,4362.25,13,/Date(1643288880000)/,1243,1495,0,0,530,649,0,2022-01-27 08:08:00
4359.75,492,537,4362.25,4357.5,4360.0,13,/Date(1643288940000)/,1003,1082,0,0,511,545,0,2022-01-27 08:09:00
4364.25,467,505,4364.25,4358.5,4359.75,13,/Date(1643289000000)/,1130,1371,0,0,663,866,0,2022-01-27 08:10:00
4361.5,615,740,4365.75,4361.25,4364.25,13,/Date(1643289060000)/,1104,1414,0,0,489,674,0,2022-01-27 08:11:00
4362.5,437,481,4364.25,4359.75,4361.25,13,/Date(1643289120000)/,834,957,0,0,397,476,0,2022-01-27 08:12:00
4359.75,514,590,4362.25,4359.25,4362.25,13,/Date(1643289180000)/,756,884,0,0,242,294,0,2022-01-27 08:13:00
4361.5,352,385,4362.0,4360.0,4360.0,13,/Date(1643289240000)/,705,785,0,0,353,400,0,2022-01-27 08:14:00
4359.0,604,949,4362.25,4358.25,4361.25,13,/Date(1643289300000)/,963,1528,0,0,359,579,0,2022-01-27 08:15:00
4359.0,405,435,4359.75,4357.75,4358.75,13,/Date(1643289360000)/,777,868,0,0,372,433,0,2022-01-27 08:16:00
4359.25,602,818,4359.75,4357.25,4359.25,13,/Date(1643289420000)/,1202,1677,0,0,600,859,0,2022-01-27 08:17:00
4359.75,767,965,4363.0,4356.5,4359.0,13,/Date(1643289480000)/,1559,1952,0,0,792,987,0,2022-01-27 08:18:00
4362.5,655,841,4363.5,4357.5,4359.75,13,/Date(1643289540000)/,1246,1512,0,0,591,671,0,2022-01-27 08:19:00
4363.75,203,214,4364.0,4361.75,4362.25,13,/Date(1643289600000)/,528,576,0,0,325,362,0,2022-01-27 08:20:00
4362.0,487,538,4365.25,4361.0,4363.75,13,/Date(1643289660000)/,793,875,0,0,306,337,0,2022-01-27 08:21:00
4359.25,661,754,4364.0,4358.0,4362.25,13,/Date(1643289720000)/,1220,1371,0,0,559,617,0,2022-01-27 08:22:00
4359.75,627,702,4361.25,4356.75,4359.5,13,/Date(1643289780000)/,1168,1336,0,0,541,634,0,2022-01-27 08:23:00
4361.0,454,477,4363.5,4359.75,4359.75,13,/Date(1643289840000)/,961,1069,0,0,507,592,0,2022-01-27 08:24:00
4365.75,542,777,4367.25,4360.25,4360.75,13,/Date(1643289900000)/,1350,1775,0,0,808,998,0,2022-01-27 08:25:00
4363.75,439,531,4365.75,4362.25,4365.75,13,/Date(1643289960000)/,724,882,0,0,285,351,0,2022-01-27 08:26:00
4369.25,350,453,4370.5,4364.0,4364.0,13,/Date(1643290020000)/,1001,1440,0,0,651,987,0,2022-01-27 08:27:00
4362.5,519,636,4369.5,4362.5,4369.25,13,/Date(1643290080000)/,758,964,0,0,239,328,0,2022-01-27 08:28:00
4362.25,234,353,4364.0,4361.25,4362.5,13,/Date(1643290140000)/,490,661,0,0,256,308,0,2022-01-27 08:29:00
4363.75,194,262,4363.75,4359.25,4362.5,13,/Date(1643290200000)/,416,568,0,0,222,306,0,2022-01-27 08:30:00
4363.75,534,629,4366.5,4361.5,4364.0,13,/Date(1643290260000)/,1097,1442,0,0,563,813,0,2022-01-27 08:31:00
4365.0,470,610,4367.0,4363.0,4363.5,13,/Date(1643290320000)/,981,1285,0,0,511,675,0,2022-01-27 08:32:00
4359.25,973,1137,4365.5,4358.0,4365.0,13,/Date(1643290380000)/,1565,1905,0,0,592,768,0,2022-01-27 08:33:00
4361.75,644,827,4362.5,4356.0,4359.25,13,/Date(1643290440000)/,1354,1707,0,0,710,880,0,2022-01-27 08:34:00
4359.0,457,558,4363.25,4358.75,4362.0,13,/Date(1643290500000)/,736,893,0,0,279,335,0,2022-01-27 08:35:00
4358.5,419,478,4361.25,4357.5,4359.25,13,/Date(1643290560000)/,846,1160,0,0,427,682,0,2022-01-27 08:36:00
4357.75,344,430,4360.0,4356.75,4358.75,13,/Date(1643290620000)/,621,818,0,0,277,388,0,2022-01-27 08:37:00
4356.5,547,690,4359.5,4354.25,4357.25,13,/Date(1643290680000)/,973,1274,0,0,426,584,0,2022-01-27 08:38:00
4358.75,373,452,4358.75,4355.5,4356.5,13,/Date(1643290740000)/,676,857,0,0,303,405,0,2022-01-27 08:39:00
4359.5,294,335,4361.5,4358.5,4358.75,13,/Date(1643290800000)/,623,723,0,0,329,388,0,2022-01-27 08:40:00
4362.75,259,282,4363.0,4357.75,4359.25,13,/Date(1643290860000)/,619,784,0,0,360,502,0,2022-01-27 08:41:00
4363.0,382,465,4364.0,4362.5,4362.75,13,/Date(1643290920000)/,730,863,0,0,348,398,0,2022-01-27 08:42:00
4362.5,274,315,4365.0,4361.75,4362.75,13,/Date(1643290980000)/,566,683,0,0,292,368,0,2022-01-27 08:43:00
4362.25,436,543,4363.75,4360.25,4362.25,13,/Date(1643291040000)/,763,906,0,0,327,363,0,2022-01-27 08:44:00
4362.5,247,270,4363.0,4361.25,4362.5,13,/Date(1643291100000)/,465,514,0,0,218,244,0,2022-01-27 08:45:00
4364.0,285,399,4365.0,4362.25,4362.25,13,/Date(1643291160000)/,671,871,0,0,386,472,0,2022-01-27 08:46:00
4365.25,361,461,4366.0,4364.0,4364.0,13,/Date(1643291220000)/,660,835,0,0,299,374,0,2022-01-27 08:47:00
4364.25,431,513,4365.25,4363.5,4365.0,13,/Date(1643291280000)/,824,1005,0,0,393,492,0,2022-01-27 08:48:00
4363.0,441,574,4364.75,4362.25,4364.25,13,/Date(1643291340000)/,666,820,0,0,225,246,0,2022-01-27 08:49:00
4369.5,455,562,4370.0,4363.25,4363.25,13,/Date(1643291400000)/,1247,1989,0,0,792,1427,0,2022-01-27 08:50:00
4369.75,588,777,4370.5,4367.5,4369.5,13,/Date(1643291460000)/,1131,1492,0,0,543,715,0,2022-01-27 08:51:00
4372.75,461,621,4373.0,4369.0,4369.75,13,/Date(1643291520000)/,1183,1566,0,0,722,945,0,2022-01-27 08:52:00
4372.5,648,841,4374.25,4371.75,4372.5,13,/Date(1643291580000)/,1141,1455,0,0,493,614,0,2022-01-27 08:53:00
4374.0,456,589,4375.0,4372.25,4372.5,13,/Date(1643291640000)/,942,1247,0,0,486,658,0,2022-01-27 08:54:00
4374.75,688,955,4375.0,4371.0,4374.0,13,/Date(1643291700000)/,1315,1850,0,0,627,895,0,2022-01-27 08:55:00
4374.25,342,477,4375.0,4373.0,4374.75,13,/Date(1643291760000)/,720,918,0,0,378,441,0,2022-01-27 08:56:00
4375.0,555,721,4376.75,4373.5,4374.5,13,/Date(1643291820000)/,1226,1664,0,0,671,943,0,2022-01-27 08:57:00
4375.5,470,686,4377.0,4373.5,4375.0,13,/Date(1643291880000)/,1059,1477,0,0,589,791,0,2022-01-27 08:58:00
4374.5,297,359,4375.5,4374.0,4375.5,13,/Date(1643291940000)/,517,636,0,0,220,277,0,2022-01-27 08:59:00
4376.0,276,357,4376.75,4374.25,4374.5,13,/Date(1643292000000)/,573,757,0,0,297,400,0,2022-01-27 09:00:00
4377.0,496,624,4377.25,4374.0,4375.75,13,/Date(1643292060000)/,986,1269,0,0,490,645,0,2022-01-27 09:01:00
4376.75,437,552,4378.0,4376.5,4377.25,13,/Date(1643292120000)/,889,1163,0,0,452,611,0,2022-01-27 09:02:00
4379.5,618,758,4380.5,4376.5,4376.5,13,/Date(1643292180000)/,1468,2002,0,0,850,1244,0,2022-01-27 09:03:00
4379.5,635,985,4379.75,4377.25,4379.25,13,/Date(1643292240000)/,1134,1671,0,0,499,686,0,2022-01-27 09:04:00
4379.0,293,388,4380.0,4378.75,4379.75,13,/Date(1643292300000)/,565,804,0,0,272,416,0,2022-01-27 09:05:00
4380.25,606,735,4381.0,4378.75,4379.0,13,/Date(1643292360000)/,1154,1413,0,0,548,678,0,2022-01-27 09:06:00
4378.25,605,763,4380.25,4377.75,4380.0,13,/Date(1643292420000)/,895,1102,0,0,290,339,0,2022-01-27 09:07:00
4376.5,521,852,4378.0,4375.25,4378.0,13,/Date(1643292480000)/,1023,1474,0,0,502,622,0,2022-01-27 09:08:00
4376.5,282,350,4378.25,4376.0,4376.5,13,/Date(1643292540000)/,572,674,0,0,290,324,0,2022-01-27 09:09:00
4377.5,370,447,4378.5,4375.0,4376.5,13,/Date(1643292600000)/,857,1202,0,0,487,755,0,2022-01-27 09:10:00
4377.5,402,558,4378.0,4376.75,4377.5,13,/Date(1643292660000)/,671,1017,0,0,269,459,0,2022-01-27 09:11:00
4377.75,299,347,4378.25,4377.25,4377.75,13,/Date(1643292720000)/,561,701,0,0,262,354,0,2022-01-27 09:12:00
4379.0,348,558,4379.25,4376.75,4377.75,13,/Date(1643292780000)/,922,1593,0,0,574,1035,0,2022-01-27 09:13:00
4382.25,405,729,4382.5,4379.0,4379.25,13,/Date(1643292840000)/,1147,2022,0,0,742,1293,0,2022-01-27 09:14:00
4383.75,498,749,4383.75,4381.5,4382.25,13,/Date(1643292900000)/,1104,1628,0,0,606,879,0,2022-01-27 09:15:00
4384.75,584,930,4385.0,4383.0,4383.75,13,/Date(1643292960000)/,1373,2202,0,0,789,1272,0,2022-01-27 09:16:00
4384.75,268,446,4385.0,4383.75,4384.75,13,/Date(1643293020000)/,690,1187,0,0,422,741,0,2022-01-27 09:17:00
4383.0,398,581,4384.75,4383.0,4384.75,13,/Date(1643293080000)/,658,978,0,0,260,397,0,2022-01-27 09:18:00
4381.75,544,695,4383.5,4381.5,4383.0,13,/Date(1643293140000)/,844,1095,0,0,300,400,0,2022-01-27 09:19:00
4381.25,337,420,4381.75,4380.75,4381.75,13,/Date(1643293200000)/,532,664,0,0,195,244,0,2022-01-27 09:20:00
4381.0,302,365,4382.75,4381.0,4381.25,13,/Date(1643293260000)/,593,808,0,0,291,443,0,2022-01-27 09:21:00
4379.5,581,797,4381.0,4378.75,4381.0,13,/Date(1643293320000)/,886,1246,0,0,305,449,0,2022-01-27 09:22:00
4378.75,360,575,4380.25,4378.75,4379.5,13,/Date(1643293380000)/,596,930,0,0,236,355,0,2022-01-27 09:23:00
4376.0,682,1010,4378.5,4375.5,4378.5,13,/Date(1643293440000)/,1203,1769,0,0,521,759,0,2022-01-27 09:24:00
4377.75,237,314,4378.0,4375.5,4375.75,13,/Date(1643293500000)/,601,842,0,0,364,528,0,2022-01-27 09:25:00
4381.5,380,513,4381.5,4378.0,4378.0,13,/Date(1643293560000)/,911,1242,0,0,531,729,0,2022-01-27 09:26:00
4381.0,397,556,4382.5,4380.0,4381.5,13,/Date(1643293620000)/,753,997,0,0,356,441,0,2022-01-27 09:27:00
4381.75,417,552,4382.75,4380.25,4380.75,13,/Date(1643293680000)/,802,1059,0,0,385,507,0,2022-01-27 09:28:00
4382.25,342,456,4382.5,4380.25,4382.0,13,/Date(1643293740000)/,787,1071,0,0,445,615,0,2022-01-27 09:29:00
4387.25,1041,1555,4389.0,4382.25,4382.25,13,/Date(1643293800000)/,2575,4238,0,0,1534,2683,0,2022-01-27 09:30:00
4390.75,4554,6359,4391.75,4384.0,4387.5,13,/Date(1643293860000)/,9396,13390,0,0,4842,7031,0,2022-01-27 09:31:00
4386.5,3666,4467,4391.0,4384.0,4390.75,13,/Date(1643293920000)/,6944,8743,0,0,3278,4276,0,2022-01-27 09:32:00
4395.75,3226,3951,4396.0,4385.5,4386.75,13,/Date(1643293980000)/,6648,8869,0,0,3422,4918,0,2022-01-27 09:33:00
4390.5,2833,3694,4395.75,4388.0,4395.5,13,/Date(1643294040000)/,4922,6630,0,0,2089,2936,0,2022-01-27 09:34:00
4381.5,3223,4177,4393.0,4380.25,4390.5,13,/Date(1643294100000)/,5638,7115,0,0,2415,2938,0,2022-01-27 09:35:00
4379.0,3444,4525,4383.75,4377.25,4381.25,13,/Date(1643294160000)/,6710,8603,0,0,3266,4078,0,2022-01-27 09:36:00
4382.25,2921,3515,4382.5,4375.75,4379.0,13,/Date(1643294220000)/,5683,7007,0,0,2762,3492,0,2022-01-27 09:37:00
4381.75,2799,3551,4387.0,4379.25,4382.0,13,/Date(1643294280000)/,5450,6931,0,0,2651,3380,0,2022-01-27 09:38:00
4383.0,2587,3356,4383.0,4375.5,4381.75,13,/Date(1643294340000)/,4978,6274,0,0,2391,2918,0,2022-01-27 09:39:00
4380.5,1646,2082,4384.0,4379.75,4383.0,13,/Date(1643294400000)/,3178,4134,0,0,1532,2052,0,2022-01-27 09:40:00
4389.0,2027,2504,4390.5,4380.5,4380.5,13,/Date(1643294460000)/,4486,5749,0,0,2459,3245,0,2022-01-27 09:41:00
4394.75,2650,3177,4395.75,4388.75,4389.0,13,/Date(1643294520000)/,5133,6327,0,0,2483,3150,0,2022-01-27 09:42:00
4395.25,2358,3187,4397.0,4392.5,4394.5,13,/Date(1643294580000)/,4906,6560,0,0,2548,3373,0,2022-01-27 09:43:00
4404.0,2472,4039,4404.75,4394.75,4395.25,13,/Date(1643294640000)/,5527,9239,0,0,3055,5200,0,2022-01-27 09:44:00
4403.75,2352,3203,4404.75,4401.75,4404.0,13,/Date(1643294700000)/,4488,6143,0,0,2136,2940,0,2022-01-27 09:45:00
4402.25,3115,4222,4406.75,4399.5,4403.75,13,/Date(1643294760000)/,5836,7922,0,0,2721,3700,0,2022-01-27 09:46:00
4402.5,2411,3077,4403.25,4396.75,4402.25,13,/Date(1643294820000)/,4641,5934,0,0,2230,2857,0,2022-01-27 09:47:00
4409.0,1904,2603,4409.5,4402.5,4402.75,13,/Date(1643294880000)/,3974,5447,0,0,2070,2844,0,2022-01-27 09:48:00
4415.25,2187,3065,4415.75,4408.5,4409.0,13,/Date(1643294940000)/,4542,6745,0,0,2355,3680,0,2022-01-27 09:49:00
4412.25,2463,3177,4416.0,4411.5,4415.5,13,/Date(1643295000000)/,4378,6014,0,0,1915,2837,0,2022-01-27 09:50:00
4415.75,2026,2682,4415.75,4411.25,4412.25,13,/Date(1643295060000)/,4084,5280,0,0,2058,2598,0,2022-01-27 09:51:00
4412.25,2356,3199,4417.75,4411.75,4415.75,13,/Date(1643295120000)/,4472,6042,0,0,2116,2843,0,2022-01-27 09:52:00
4415.5,2554,3350,4416.0,4410.0,4412.25,13,/Date(1643295180000)/,5000,7173,0,0,2446,3823,0,2022-01-27 09:53:00
4413.5,1890,2532,4416.0,4410.75,4415.25,13,/Date(1643295240000)/,3527,4813,0,0,1637,2281,0,2022-01-27 09:54:00
4414.0,2092,3144,4418.5,4413.0,4413.75,13,/Date(1643295300000)/,4127,6398,0,0,2035,3254,0,2022-01-27 09:55:00
4411.75,2904,4161,4415.0,4407.5,4414.0,13,/Date(1643295360000)/,5156,7024,0,0,2252,2863,0,2022-01-27 09:56:00
4402.0,3297,4426,4413.0,4401.75,4412.0,13,/Date(1643295420000)/,5728,7643,0,0,2431,3217,0,2022-01-27 09:57:00
4398.0,2445,3799,4402.75,4397.5,4402.0,13,/Date(1643295480000)/,4538,6712,0,0,2093,2913,0,2022-01-27 09:58:00
4403.5,1706,2273,4406.0,4397.75,4398.0,13,/Date(1643295540000)/,3595,5102,0,0,1889,2829,0,2022-01-27 09:59:00
4408.25,1409,1985,4409.0,4402.0,4403.25,13,/Date(1643295600000)/,2927,4148,0,0,1518,2163,0,2022-01-27 10:00:00
4392.25,4149,5535,4409.75,4392.0,4408.25,13,/Date(1643295660000)/,7535,9601,0,0,3386,4066,0,2022-01-27 10:01:00
4397.5,2975,3772,4400.0,4390.5,4392.25,13,/Date(1643295720000)/,6124,7763,0,0,3149,3991,0,2022-01-27 10:02:00
4401.25,1750,2244,4402.0,4394.5,4397.5,13,/Date(1643295780000)/,3689,4636,0,0,1939,2392,0,2022-01-27 10:03:00
4402.5,1681,2485,4403.75,4399.75,4401.0,13,/Date(1643295840000)/,3244,4660,0,0,1563,2175,0,2022-01-27 10:04:00
4411.75,2126,2990,4412.25,4401.75,4402.75,13,/Date(1643295900000)/,4724,6752,0,0,2598,3762,0,2022-01-27 10:05:00
4409.25,2128,2762,4414.25,4407.0,4411.75,13,/Date(1643295960000)/,3848,5219,0,0,1720,2457,0,2022-01-27 10:06:00
4408.25,1599,2082,4412.75,4406.0,4409.25,13,/Date(1643296020000)/,3303,4241,0,0,1704,2159,0,2022-01-27 10:07:00
4411.75,1660,2039,4412.75,4408.0,4408.25,13,/Date(1643296080000)/,3628,4618,0,0,1968,2579,0,2022-01-27 10:08:00
4416.0,1880,2345,4417.0,4409.75,4411.5,13,/Date(1643296140000)/,3789,4869,0,0,1909,2524,0,2022-01-27 10:09:00
4415.25,2204,2826,4419.75,4412.5,4416.0,13,/Date(1643296200000)/,4308,5560,0,0,2104,2734,0,2022-01-27 10:10:00
4414.0,2059,2610,4416.5,4409.0,4415.25,13,/Date(1643296260000)/,4112,5045,0,0,2053,2435,0,2022-01-27 10:11:00
4419.5,2000,2851,4422.0,4414.0,4414.0,13,/Date(1643296320000)/,4497,6323,0,0,2497,3472,0,2022-01-27 10:12:00
4413.5,1606,2210,4420.0,4413.5,4419.5,13,/Date(1643296380000)/,2963,3880,0,0,1357,1670,0,2022-01-27 10:13:00
4417.0,1682,1995,4420.0,4413.0,4413.5,13,/Date(1643296440000)/,3431,4250,0,0,1749,2255,0,2022-01-27 10:14:00
4418.25,1368,1715,4420.25,4415.25,4417.25,13,/Date(1643296500000)/,2792,3559,0,0,1424,1844,0,2022-01-27 10:15:00
4419.0,1703,2377,4419.75,4415.25,4418.5,13,/Date(1643296560000)/,3047,4062,0,0,1344,1685,0,2022-01-27 10:16:00
4414.5,2568,3507,4419.0,4410.5,4419.0,13,/Date(1643296620000)/,4813,6373,0,0,2245,2866,0,2022-01-27 10:17:00
4412.75,1608,2156,4417.0,4412.0,4414.75,13,/Date(1643296680000)/,3084,4093,0,0,1476,1937,0,2022-01-27 10:18:00
4412.5,1826,2561,4414.75,4409.75,4412.75,13,/Date(1643296740000)/,3726,5110,0,0,1900,2549,0,2022-01-27 10:19:00
4409.25,1920,2509,4412.75,4406.5,4412.5,13,/Date(1643296800000)/,3486,4332,0,0,1566,1823,0,2022-01-27 10:20:00
4407.0,1739,2186,4411.75,4406.5,4409.25,13,/Date(1643296860000)/,3539,4352,0,0,1800,2166,0,2022-01-27 10:21:00
4411.0,1714,2161,4411.5,4405.25,4407.25,13,/Date(1643296920000)/,3473,4330,0,0,1759,2169,0,2022-01-27 10:22:00
4409.25,1421,1620,4411.75,4405.75,4411.0,13,/Date(1643296980000)/,2483,2816,0,0,1062,1196,0,2022-01-27 10:23:00
4404.0,2150,2555,4412.75,4402.5,4409.0,13,/Date(1643297040000)/,3984,4683,0,0,1834,2128,0,2022-01-27 10:24:00
4400.75,1972,2691,4405.0,4399.0,4404.0,13,/Date(1643297100000)/,3520,4669,0,0,1548,1978,0,2022-01-27 10:25:00
4396.0,2137,2690,4403.75,4395.5,4400.75,13,/Date(1643297160000)/,3937,4701,0,0,1800,2011,0,2022-01-27 10:26:00
4398.5,1776,2284,4400.75,4395.5,4396.0,13,/Date(1643297220000)/,3547,4501,0,0,1771,2217,0,2022-01-27 10:27:00
4392.75,2227,2949,4400.75,4391.5,4398.75,13,/Date(1643297280000)/,4223,5315,0,0,1996,2366,0,2022-01-27 10:28:00
4387.5,2975,3840,4394.25,4386.5,4393.0,13,/Date(1643297340000)/,5346,6775,0,0,2371,2935,0,2022-01-27 10:29:00
4379.5,3197,4366,4391.25,4379.25,4387.75,13,/Date(1643297400000)/,5699,7546,0,0,2502,3180,0,2022-01-27 10:30:00
4384.5,2610,3226,4385.25,4379.5,4379.75,13,/Date(1643297460000)/,5688,7201,0,0,3078,3975,0,2022-01-27 10:31:00
4374.25,3598,4920,4384.75,4371.5,4384.75,13,/Date(1643297520000)/,6571,8618,0,0,2973,3698,0,2022-01-27 10:32:00
4373.0,2621,3197,4378.75,4372.0,4374.25,13,/Date(1643297580000)/,5238,6177,0,0,2617,2980,0,2022-01-27 10:33:00
4375.5,2226,2629,4377.75,4372.25,4372.75,13,/Date(1643297640000)/,4340,5082,0,0,2114,2453,0,2022-01-27 10:34:00
4377.75,2162,2732,4379.25,4373.5,4375.5,13,/Date(1643297700000)/,4430,5524,0,0,2268,2792,0,2022-01-27 10:35:00
4377.5,2288,2674,4379.0,4371.75,4377.5,13,/Date(1643297760000)/,4480,5244,0,0,2192,2570,0,2022-01-27 10:36:00
4373.5,1906,2382,4377.75,4372.5,4377.5,13,/Date(1643297820000)/,3588,4240,0,0,1682,1858,0,2022-01-27 10:37:00
4377.25,1174,1468,4378.5,4373.5,4373.75,13,/Date(1643297880000)/,2624,3153,0,0,1450,1685,0,2022-01-27 10:38:00
4377.75,1861,2381,4380.75,4376.25,4377.25,13,/Date(1643297940000)/,3896,5125,0,0,2035,2744,0,2022-01-27 10:39:00
4368.25,2986,3904,4378.0,4364.5,4377.75,13,/Date(1643298000000)/,5604,7210,0,0,2618,3306,0,2022-01-27 10:40:00
4368.75,2240,2585,4373.25,4365.75,4368.5,13,/Date(1643298060000)/,4600,5420,0,0,2360,2835,0,2022-01-27 10:41:00
4373.5,1366,1670,4375.25,4368.75,4369.0,13,/Date(1643298120000)/,3091,3877,0,0,1725,2207,0,2022-01-27 10:42:00
4378.5,2216,2524,4380.0,4373.25,4373.5,13,/Date(1643298180000)/,4401,5245,0,0,2185,2721,0,2022-01-27 10:43:00
4382.0,1479,1766,4382.25,4374.75,4378.5,13,/Date(1643298240000)/,3511,4254,0,0,2032,2488,0,2022-01-27 10:44:00
4384.5,1675,2100,4385.75,4379.25,4382.0,13,/Date(1643298300000)/,3515,4381,0,0,1840,2281,0,2022-01-27 10:45:00
4385.75,1777,2093,4386.75,4382.0,4384.5,13,/Date(1643298360000)/,3651,4408,0,0,1874,2315,0,2022-01-27 10:46:00
4384.5,1192,1445,4385.75,4382.5,4385.75,13,/Date(1643298420000)/,2583,3104,0,0,1391,1659,0,2022-01-27 10:47:00
4382.0,1370,1788,4387.75,4381.25,4384.75,13,/Date(1643298480000)/,2658,3369,0,0,1288,1581,0,2022-01-27 10:48:00
4378.25,1924,2379,4382.25,4375.5,4382.0,13,/Date(1643298540000)/,3698,4556,0,0,1774,2177,0,2022-01-27 10:49:00
4380.5,1760,2070,4384.0,4376.5,4378.5,13,/Date(1643298600000)/,3683,4256,0,0,1923,2186,0,2022-01-27 10:50:00
4383.0,1604,1892,4386.0,4378.25,4380.25,13,/Date(1643298660000)/,3172,3725,0,0,1568,1833,0,2022-01-27 10:51:00
4382.5,1744,2076,4386.25,4381.5,4383.25,13,/Date(1643298720000)/,3417,4392,0,0,1673,2316,0,2022-01-27 10:52:00
4381.5,1371,1672,4384.75,4380.5,4382.25,13,/Date(1643298780000)/,2458,3027,0,0,1087,1355,0,2022-01-27 10:53:00
4383.75,1972,2671,4385.0,4377.25,4381.5,13,/Date(1643298840000)/,3828,4914,0,0,1856,2243,0,2022-01-27 10:54:00
4383.0,1659,1987,4386.25,4381.0,4383.5,13,/Date(1643298900000)/,3301,4065,0,0,1642,2078,0,2022-01-27 10:55:00
4382.5,1810,2098,4387.75,4382.0,4382.75,13,/Date(1643298960000)/,3376,4078,0,0,1566,1980,0,2022-01-27 10:56:00
4386.75,1595,1983,4387.25,4382.0,4382.5,13,/Date(1643299020000)/,2956,3944,0,0,1361,1961,0,2022-01-27 10:57:00
4392.5,2600,3281,4394.0,4386.5,4386.5,13,/Date(1643299080000)/,5398,7069,0,0,2798,3788,0,2022-01-27 10:58:00
4399.0,1977,2488,4400.0,4391.5,4392.5,13,/Date(1643299140000)/,4226,5667,0,0,2249,3179,0,2022-01-27 10:59:00
4397.25,1741,2112,4399.75,4396.0,4398.75,13,/Date(1643299200000)/,3079,3831,0,0,1338,1719,0,2022-01-27 11:00:00
4404.5,2560,3525,4405.5,4397.0,4397.25,13,/Date(1643299260000)/,5235,7543,0,0,2675,4018,0,2022-01-27 11:01:00
4404.5,1196,1363,4405.75,4402.5,4404.25,13,/Date(1643299320000)/,2283,2754,0,0,1087,1391,0,2022-01-27 11:02:00
4407.25,1351,1665,4409.25,4403.5,4404.5,13,/Date(1643299380000)/,2704,3466,0,0,1353,1801,0,2022-01-27 11:03:00
4405.75,1360,1585,4408.75,4404.5,4407.0,13,/Date(1643299440000)/,2616,3083,0,0,1256,1498,0,2022-01-27 11:04:00
4404.0,1446,1939,4406.75,4404.0,4406.0,13,/Date(1643299500000)/,2566,3307,0,0,1120,1368,0,2022-01-27 11:05:00
4406.5,1275,1476,4407.0,4402.75,4404.25,13,/Date(1643299560000)/,2486,3179,0,0,1211,1703,0,2022-01-27 11:06:00
4403.25,1496,1864,4407.75,4401.75,4406.5,13,/Date(1643299620000)/,2517,3196,0,0,1021,1332,0,2022-01-27 11:07:00
4395.25,2092,3075,4405.25,4394.5,4403.25,13,/Date(1643299680000)/,3256,4504,0,0,1164,1429,0,2022-01-27 11:08:00
4394.0,2399,3069,4397.75,4391.25,4395.5,13,/Date(1643299740000)/,4494,6228,0,0,2095,3159,0,2022-01-27 11:09:00
4394.0,1315,1515,4395.75,4391.5,4394.0,13,/Date(1643299800000)/,2636,3047,0,0,1321,1532,0,2022-01-27 11:10:00
4399.0,1353,1588,4401.0,4393.5,4394.25,13,/Date(1643299860000)/,2885,3430,0,0,1532,1842,0,2022-01-27 11:11:00
4400.0,1437,1681,4402.5,4398.75,4399.0,13,/Date(1643299920000)/,2776,3336,0,0,1339,1655,0,2022-01-27 11:12:00
4401.0,1235,1423,4401.25,4398.5,4400.0,13,/Date(1643299980000)/,2426,2829,0,0,1191,1406,0,2022-01-27 11:13:00
4405.5,1376,1804,4406.5,4400.0,4401.0,13,/Date(1643300040000)/,2917,3842,0,0,1541,2038,0,2022-01-27 11:14:00
4403.75,1204,1437,4406.5,4401.5,4405.5,13,/Date(1643300100000)/,2086,2486,0,0,882,1049,0,2022-01-27 11:15:00
4392.25,2360,2949,4404.25,4391.75,4404.0,13,/Date(1643300160000)/,3795,4787,0,0,1435,1838,0,2022-01-27 11:16:00
4388.75,2581,3459,4395.0,4385.0,4392.25,13,/Date(1643300220000)/,4883,6453,0,0,2302,2994,0,2022-01-27 11:17:00
4387.25,1286,1643,4389.5,4385.0,4388.5,13,/Date(1643300280000)/,2367,3039,0,0,1081,1396,0,2022-01-27 11:18:00
4384.75,1318,1990,4387.25,4383.75,4387.25,13,/Date(1643300340000)/,2478,3517,0,0,1160,1527,0,2022-01-27 11:19:00
4390.0,1144,1618,4392.0,4383.75,4384.5,13,/Date(1643300400000)/,2730,3733,0,0,1586,2115,0,2022-01-27 11:20:00
4389.5,1144,1397,4392.0,4386.75,4389.75,13,/Date(1643300460000)/,2212,2684,0,0,1068,1287,0,2022-01-27 11:21:00
4393.75,1105,1246,4395.5,4389.25,4389.5,13,/Date(1643300520000)/,2363,2808,0,0,1258,1562,0,2022-01-27 11:22:00
4393.0,1150,1386,4394.0,4391.0,4393.75,13,/Date(1643300580000)/,2092,2503,0,0,942,1117,0,2022-01-27 11:23:00
4390.75,1197,1503,4393.5,4388.25,4392.75,13,/Date(1643300640000)/,2120,2617,0,0,923,1114,0,2022-01-27 11:24:00
4387.25,1445,2273,4391.25,4384.25,4390.75,13,/Date(1643300700000)/,2652,3683,0,0,1207,1410,0,2022-01-27 11:25:00
4382.75,1675,2145,4388.75,4381.0,4387.25,13,/Date(1643300760000)/,3201,4015,0,0,1526,1870,0,2022-01-27 11:26:00
4378.5,2284,3120,4382.25,4375.5,4382.25,13,/Date(1643300820000)/,4059,5340,0,0,1775,2220,0,2022-01-27 11:27:00
4382.0,1234,1358,4383.25,4377.5,4378.75,13,/Date(1643300880000)/,2544,2947,0,0,1310,1589,0,2022-01-27 11:28:00
4380.25,1117,1391,4382.5,4379.25,4382.25,13,/Date(1643300940000)/,2102,2617,0,0,985,1226,0,2022-01-27 11:29:00
4381.75,1252,1571,4382.0,4377.5,4380.25,13,/Date(1643301000000)/,2418,2920,0,0,1166,1349,0,2022-01-27 11:30:00
4386.5,1398,1672,4386.75,4380.0,4382.0,13,/Date(1643301060000)/,2905,3650,0,0,1507,1978,0,2022-01-27 11:31:00
4382.75,1339,1594,4388.0,4382.25,4386.5,13,/Date(1643301120000)/,2548,3024,0,0,1209,1430,0,2022-01-27 11:32:00
4385.25,889,1020,4387.25,4382.5,4383.0,13,/Date(1643301180000)/,1878,2167,0,0,989,1147,0,2022-01-27 11:33:00
4395.0,1621,2151,4395.25,4385.25,4385.5,13,/Date(1643301240000)/,3414,4726,0,0,1793,2575,0,2022-01-27 11:34:00
4396.25,1090,1347,4396.75,4393.0,4395.0,13,/Date(1643301300000)/,2170,2623,0,0,1080,1276,0,2022-01-27 11:35:00
4397.0,1387,1720,4399.0,4395.75,4396.0,13,/Date(1643301360000)/,2759,3365,0,0,1372,1645,0,2022-01-27 11:36:00
4400.25,819,1118,4401.25,4396.5,4397.0,13,/Date(1643301420000)/,1978,2693,0,0,1159,1575,0,2022-01-27 11:37:00
4397.25,1152,1580,4401.25,4397.0,4400.5,13,/Date(1643301480000)/,2035,2636,0,0,883,1056,0,2022-01-27 11:38:00
4395.25,1384,1679,4399.25,4393.25,4397.25,13,/Date(1643301540000)/,2361,2788,0,0,977,1109,0,2022-01-27 11:39:00
4393.25,1021,1250,4396.0,4391.25,4395.25,13,/Date(1643301600000)/,2088,2468,0,0,1067,1218,0,2022-01-27 11:40:00
4399.75,1236,1438,4400.25,4392.5,4393.5,13,/Date(1643301660000)/,2641,3056,0,0,1405,1618,0,2022-01-27 11:41:00
4398.5,1688,2028,4403.25,4397.75,4399.75,13,/Date(1643301720000)/,3269,3844,0,0,1581,1816,0,2022-01-27 11:42:00
4396.0,1527,1854,4398.75,4392.75,4398.5,13,/Date(1643301780000)/,2981,3659,0,0,1454,1805,0,2022-01-27 11:43:00
4396.0,1219,1366,4397.75,4393.5,4396.0,13,/Date(1643301840000)/,2313,2632,0,0,1094,1266,0,2022-01-27 11:44:00
4395.25,1004,1119,4396.5,4393.0,4396.0,13,/Date(1643301900000)/,1931,2156,0,0,927,1037,0,2022-01-27 11:45:00
4397.25,1136,1280,4399.25,4395.25,4395.5,13,/Date(1643301960000)/,2337,2726,0,0,1201,1446,0,2022-01-27 11:46:00
4397.25,1170,1421,4400.25,4395.0,4397.25,13,/Date(1643302020000)/,2251,2792,0,0,1081,1371,0,2022-01-27 11:47:00
4397.0,1033,1261,4399.0,4395.5,4397.25,13,/Date(1643302080000)/,1961,2341,0,0,928,1080,0,2022-01-27 11:48:00
4394.25,1210,1451,4397.5,4391.25,4397.0,13,/Date(1643302140000)/,2240,2622,0,0,1030,1171,0,2022-01-27 11:49:00
4393.25,891,1037,4395.75,4392.5,4394.25,13,/Date(1643302200000)/,1721,2032,0,0,830,995,0,2022-01-27 11:50:00
4393.5,1386,1689,4394.5,4389.5,4393.0,13,/Date(1643302260000)/,2508,2940,0,0,1122,1251,0,2022-01-27 11:51:00
4390.75,1237,1564,4396.0,4389.25,4393.5,13,/Date(1643302320000)/,2264,2771,0,0,1027,1207,0,2022-01-27 11:52:00
4393.75,1248,1534,4395.5,4388.5,4391.0,13,/Date(1643302380000)/,2433,2857,0,0,1185,1323,0,2022-01-27 11:53:00
4396.0,1008,1233,4397.25,4393.0,4393.5,13,/Date(1643302440000)/,2097,2744,0,0,1089,1511,0,2022-01-27 11:54:00
4396.0,647,761,4396.75,4394.0,4396.25,13,/Date(1643302500000)/,1297,1515,0,0,650,754,0,2022-01-27 11:55:00
4394.0,1012,1329,4397.25,4392.0,4396.0,13,/Date(1643302560000)/,1978,2480,0,0,966,1151,0,2022-01-27 11:56:00
4392.0,900,1091,4395.75,4391.0,4394.25,13,/Date(1643302620000)/,1849,2213,0,0,949,1122,0,2022-01-27 11:57:00
4394.5,816,927,4395.25,4391.0,4392.25,13,/Date(1643302680000)/,1662,2085,0,0,846,1158,0,2022-01-27 11:58:00
4395.0,911,1028,4396.25,4392.75,4394.5,13,/Date(1643302740000)/,1920,2199,0,0,1009,1171,0,2022-01-27 11:59:00
4394.5,906,1067,4395.75,4392.75,4395.0,13,/Date(1643302800000)/,1488,1710,0,0,582,643,0,2022-01-27 12:00:00
4390.25,1403,1676,4395.75,4388.5,4394.5,13,/Date(1643302860000)/,2558,3011,0,0,1155,1335,0,2022-01-27 12:01:00
4392.5,749,859,4393.5,4390.0,4390.25,13,/Date(1643302920000)/,1610,1813,0,0,861,954,0,2022-01-27 12:02:00
4392.25,724,953,4394.5,4391.0,4392.75,13,/Date(1643302980000)/,1546,1947,0,0,822,994,0,2022-01-27 12:03:00
4388.25,974,1353,4392.25,4387.5,4392.25,13,/Date(1643303040000)/,1848,2444,0,0,874,1091,0,2022-01-27 12:04:00
4392.75,1555,1998,4393.5,4384.75,4388.5,13,/Date(1643303100000)/,3119,3901,0,0,1564,1903,0,2022-01-27 12:05:00
4386.75,1372,1698,4392.5,4386.0,4392.5,13,/Date(1643303160000)/,2185,2646,0,0,813,948,0,2022-01-27 12:06:00
4386.25,1136,1314,4388.25,4384.75,4386.75,13,/Date(1643303220000)/,2110,2421,0,0,974,1107,0,2022-01-27 12:07:00
4381.75,1557,1892,4386.5,4381.75,4386.25,13,/Date(1643303280000)/,2551,3030,0,0,994,1138,0,2022-01-27 12:08:00
4379.25,1593,2131,4382.5,4378.75,4382.0,13,/Date(1643303340000)/,3065,3963,0,0,1472,1832,0,2022-01-27 12:09:00
4377.75,1388,1668,4380.0,4374.75,4379.5,13,/Date(1643303400000)/,2794,3402,0,0,1406,1734,0,2022-01-27 12:10:00
4373.0,2040,2638,4379.5,4370.75,4378.0,13,/Date(1643303460000)/,4026,5165,0,0,1986,2527,0,2022-01-27 12:11:00
4375.25,1130,1394,4377.25,4372.75,4373.25,13,/Date(1643303520000)/,2295,2838,0,0,1165,1444,0,2022-01-27 12:12:00
4374.5,1093,1316,4375.75,4372.25,4375.25,13,/Date(1643303580000)/,2098,2524,0,0,1005,1208,0,2022-01-27 12:13:00
4373.75,958,1113,4375.25,4373.25,4374.75,13,/Date(1643303640000)/,1710,1951,0,0,752,838,0,2022-01-27 12:14:00
4373.5,1583,2173,4374.25,4368.25,4374.0,13,/Date(1643303700000)/,2898,3802,0,0,1315,1629,0,2022-01-27 12:15:00
4370.0,1105,1346,4373.75,4369.0,4373.75,13,/Date(1643303760000)/,2117,2569,0,0,1012,1223,0,2022-01-27 12:16:00
4365.75,2022,2601,4370.75,4363.5,4370.25,13,/Date(1643303820000)/,3937,4900,0,0,1915,2299,0,2022-01-27 12:17:00
4363.0,1450,1905,4366.75,4362.0,4366.0,13,/Date(1643303880000)/,2816,3772,0,0,1366,1867,0,2022-01-27 12:18:00
4359.5,2268,3394,4364.75,4359.25,4362.75,13,/Date(1643303940000)/,4247,6479,0,0,1979,3085,0,2022-01-27 12:19:00
4362.25,1784,2216,4363.0,4357.75,4359.75,13,/Date(1643304000000)/,3655,4698,0,0,1871,2482,0,2022-01-27 12:20:00
4362.25,1484,1909,4363.5,4359.75,4362.25,13,/Date(1643304060000)/,2943,3753,0,0,1459,1844,0,2022-01-27 12:21:00
4360.0,1244,1589,4362.25,4358.0,4362.25,13,/Date(1643304120000)/,2296,3043,0,0,1052,1454,0,2022-01-27 12:22:00
4357.75,1837,2478,4361.0,4356.75,4359.75,13,/Date(1643304180000)/,3436,4573,0,0,1599,2095,0,2022-01-27 12:23:00
4359.5,1592,2069,4361.0,4355.25,4357.75,13,/Date(1643304240000)/,3202,4530,0,0,1610,2461,0,2022-01-27 12:24:00
4358.0,1334,1736,4360.75,4356.0,4359.75,13,/Date(1643304300000)/,2661,3429,0,0,1327,1693,0,2022-01-27 12:25:00
4361.75,1250,1612,4363.5,4358.25,4358.25,13,/Date(1643304360000)/,3114,4658,0,0,1864,3046,0,2022-01-27 12:26:00
4362.5,1364,1560,4364.0,4359.25,4361.5,13,/Date(1643304420000)/,2576,3011,0,0,1212,1451,0,2022-01-27 12:27:00
4353.75,2380,3014,4363.0,4353.25,4362.25,13,/Date(1643304480000)/,3937,4824,0,0,1557,1810,0,2022-01-27 12:28:00
4355.5,1554,1946,4358.0,4354.0,4354.0,13,/Date(1643304540000)/,3522,4462,0,0,1968,2516,0,2022-01-27 12:29:00
4357.25,1355,1683,4359.0,4353.25,4355.75,13,/Date(1643304600000)/,2936,4010,0,0,1581,2327,0,2022-01-27 12:30:00
4357.5,1044,1424,4360.75,4356.0,4357.0,13,/Date(1643304660000)/,2248,3078,0,0,1204,1654,0,2022-01-27 12:31:00
4347.5,3036,3953,4357.5,4347.25,4357.5,13,/Date(1643304720000)/,5105,6490,0,0,2069,2537,0,2022-01-27 12:32:00
4350.75,1624,1994,4352.25,4347.25,4347.5,13,/Date(1643304780000)/,3711,4923,0,0,2087,2929,0,2022-01-27 12:33:00
4351.5,1217,1463,4354.5,4349.5,4350.75,13,/Date(1643304840000)/,2725,3412,0,0,1508,1949,0,2022-01-27 12:34:00
4348.75,1416,1740,4353.75,4348.0,4351.5,13,/Date(1643304900000)/,2524,2973,0,0,1108,1233,0,2022-01-27 12:35:00
4345.0,2732,3606,4350.0,4342.75,4348.75,13,/Date(1643304960000)/,4818,6269,0,0,2086,2663,0,2022-01-27 12:36:00
4347.0,1514,1777,4348.75,4344.75,4344.75,13,/Date(1643305020000)/,3049,3772,0,0,1535,1995,0,2022-01-27 12:37:00
4347.25,894,1091,4347.75,4344.5,4346.75,13,/Date(1643305080000)/,1795,2120,0,0,901,1029,0,2022-01-27 12:38:00
4339.75,2640,3608,4348.5,4339.0,4347.0,13,/Date(1643305140000)/,4669,6286,0,0,2029,2678,0,2022-01-27 12:39:00
4343.75,1479,1678,4345.5,4339.5,4339.75,13,/Date(1643305200000)/,3605,4379,0,0,2126,2701,0,2022-01-27 12:40:00
4342.5,1372,1784,4345.0,4342.0,4343.75,13,/Date(1643305260000)/,2803,3734,0,0,1431,1950,0,2022-01-27 12:41:00
4341.0,1256,1522,4344.25,4341.0,4342.5,13,/Date(1643305320000)/,2216,2818,0,0,960,1296,0,2022-01-27 12:42:00
4344.5,1504,1806,4348.0,4340.25,4340.75,13,/Date(1643305380000)/,3199,4200,0,0,1695,2394,0,2022-01-27 12:43:00
4345.0,1099,1351,4347.0,4344.25,4344.5,13,/Date(1643305440000)/,2476,3211,0,0,1377,1860,0,2022-01-27 12:44:00
4343.5,1180,1442,4346.5,4342.5,4345.25,13,/Date(1643305500000)/,2185,2762,0,0,1005,1320,0,2022-01-27 12:45:00
4337.75,2077,2669,4343.75,4335.5,4343.5,13,/Date(1643305560000)/,3916,5022,0,0,1839,2353,0,2022-01-27 12:46:00
4332.5,2319,2905,4338.25,4331.25,4337.5,13,/Date(1643305620000)/,4277,5792,0,0,1958,2887,0,2022-01-27 12:47:00
4333.75,1139,1603,4335.75,4332.25,4332.5,13,/Date(1643305680000)/,2531,3457,0,0,1392,1854,0,2022-01-27 12:48:00
4333.25,1320,1803,4335.75,4330.5,4334.0,13,/Date(1643305740000)/,2590,3320,0,0,1270,1517,0,2022-01-27 12:49:00
4332.25,1506,1949,4336.5,4330.25,4333.0,13,/Date(1643305800000)/,2930,3683,0,0,1424,1734,0,2022-01-27 12:50:00
4339.0,1620,1835,4340.75,4332.5,4332.5,13,/Date(1643305860000)/,4100,5457,0,0,2480,3622,0,2022-01-27 12:51:00
4337.75,1422,1844,4340.75,4335.25,4339.0,13,/Date(1643305920000)/,3109,3934,0,0,1687,2090,0,2022-01-27 12:52:00
4340.25,1660,2106,4343.0,4337.5,4338.0,13,/Date(1643305980000)/,3841,5124,0,0,2181,3018,0,2022-01-27 12:53:00
4339.75,1179,1395,4342.0,4337.5,4340.0,13,/Date(1643306040000)/,2286,2991,0,0,1107,1596,0,2022-01-27 12:54:00
4340.75,798,966,4342.0,4339.25,4340.0,13,/Date(1643306100000)/,1740,2069,0,0,942,1103,0,2022-01-27 12:55:00
4344.25,1344,1751,4346.0,4340.0,4340.75,13,/Date(1643306160000)/,3148,4338,0,0,1804,2587,0,2022-01-27 12:56:00
4349.75,1762,2234,4351.25,4343.75,4344.0,13,/Date(1643306220000)/,3919,5475,0,0,2157,3241,0,2022-01-27 12:57:00
4351.25,1345,1588,4353.0,4348.0,4349.5,13,/Date(1643306280000)/,2934,3693,0,0,1589,2105,0,2022-01-27 12:58:00
4346.5,1532,1843,4351.0,4344.5,4351.0,13,/Date(1643306340000)/,2872,3522,0,0,1340,1679,0,2022-01-27 12:59:00
4345.0,1509,1816,4347.0,4341.75,4346.25,13,/Date(1643306400000)/,3060,3828,0,0,1551,2012,0,2022-01-27 13:00:00
4349.0,1699,2089,4350.0,4343.25,4345.0,13,/Date(1643306460000)/,3447,4400,0,0,1748,2311,0,2022-01-27 13:01:00
4345.75,1695,2318,4349.75,4343.5,4348.75,13,/Date(1643306520000)/,3341,4310,0,0,1646,1992,0,2022-01-27 13:02:00
4337.75,1710,2141,4349.0,4337.75,4345.75,13,/Date(1643306580000)/,3255,4130,0,0,1545,1989,0,2022-01-27 13:03:00
4337.25,1654,2022,4340.5,4335.5,4337.75,13,/Date(1643306640000)/,3187,3937,0,0,1533,1915,0,2022-01-27 13:04:00
4333.0,1587,1879,4338.0,4331.75,4337.0,13,/Date(1643306700000)/,2909,3464,0,0,1322,1585,0,2022-01-27 13:05:00
4333.75,1288,1523,4334.75,4330.75,4333.0,13,/Date(1643306760000)/,2724,3341,0,0,1436,1818,0,2022-01-27 13:06:00
4326.25,1996,2804,4334.0,4326.0,4334.0,13,/Date(1643306820000)/,3273,4361,0,0,1277,1557,0,2022-01-27 13:07:00
4324.25,2021,2806,4327.5,4322.25,4326.25,13,/Date(1643306880000)/,3866,5050,0,0,1845,2244,0,2022-01-27 13:08:00
4328.25,1314,1610,4329.5,4324.25,4324.25,13,/Date(1643306940000)/,3069,3796,0,0,1755,2186,0,2022-01-27 13:09:00
4329.5,1215,1581,4332.75,4326.25,4328.25,13,/Date(1643307000000)/,2602,3331,0,0,1387,1750,0,2022-01-27 13:10:00
4325.25,1059,1371,4330.25,4324.0,4329.5,13,/Date(1643307060000)/,1925,2538,0,0,866,1167,0,2022-01-27 13:11:00
4323.75,1313,1748,4327.0,4321.25,4325.25,13,/Date(1643307120000)/,2576,3373,0,0,1263,1625,0,2022-01-27 13:12:00
4323.25,881,1126,4324.0,4321.75,4323.5,13,/Date(1643307180000)/,1786,2341,0,0,905,1215,0,2022-01-27 13:13:00
4326.25,1229,1470,4328.75,4322.0,4323.25,13,/Date(1643307240000)/,2731,3418,0,0,1502,1948,0,2022-01-27 13:14:00
4326.5,915,1101,4329.0,4324.5,4326.0,13,/Date(1643307300000)/,1875,2271,0,0,960,1170,0,2022-01-27 13:15:00
4331.25,2406,2926,4335.0,4325.25,4326.25,13,/Date(1643307360000)/,4790,5882,0,0,2384,2956,0,2022-01-27 13:16:00
4328.75,1465,1701,4333.25,4327.25,4331.25,13,/Date(1643307420000)/,2805,3453,0,0,1340,1752,0,2022-01-27 13:17:00
4318.75,2454,3340,4329.75,4318.75,4328.5,13,/Date(1643307480000)/,4202,5462,0,0,1748,2122,0,2022-01-27 13:18:00
4320.25,1397,1651,4324.25,4318.75,4319.25,13,/Date(1643307540000)/,2887,3500,0,0,1490,1849,0,2022-01-27 13:19:00
4320.25,1451,1812,4324.75,4319.25,4320.25,13,/Date(1643307600000)/,2850,3640,0,0,1399,1828,0,2022-01-27 13:20:00
4316.5,1679,2227,4322.0,4315.5,4320.0,13,/Date(1643307660000)/,2961,3819,0,0,1282,1592,0,2022-01-27 13:21:00
4313.75,1698,2327,4317.0,4312.0,4316.5,13,/Date(1643307720000)/,3696,4888,0,0,1998,2561,0,2022-01-27 13:22:00
4314.0,1198,1497,4315.75,4312.0,4313.75,13,/Date(1643307780000)/,2452,3101,0,0,1254,1604,0,2022-01-27 13:23:00
4310.75,1788,2468,4314.5,4308.75,4314.0,13,/Date(1643307840000)/,3349,4532,0,0,1561,2064,0,2022-01-27 13:24:00
4308.0,1432,1855,4311.0,4307.0,4310.75,13,/Date(1643307900000)/,2671,3795,0,0,1239,1940,0,2022-01-27 13:25:00
4309.25,1149,1376,4310.75,4307.75,4307.75,13,/Date(1643307960000)/,2356,2919,0,0,1207,1543,0,2022-01-27 13:26:00
4312.25,1730,2132,4316.0,4308.75,4309.0,13,/Date(1643308020000)/,3580,4764,0,0,1850,2632,0,2022-01-27 13:27:00
4314.5,1009,1149,4315.25,4310.0,4312.25,13,/Date(1643308080000)/,2137,2455,0,0,1128,1306,0,2022-01-27 13:28:00
4312.25,776,964,4314.75,4311.0,4314.5,13,/Date(1643308140000)/,1733,2114,0,0,957,1150,0,2022-01-27 13:29:00
4308.0,1604,1982,4312.25,4305.25,4312.25,13,/Date(1643308200000)/,2739,3290,0,0,1135,1308,0,2022-01-27 13:30:00
4314.5,2488,2964,4317.75,4306.0,4308.0,13,/Date(1643308260000)/,4891,6001,0,0,2403,3037,0,2022-01-27 13:31:00
4316.75,1436,1700,4317.25,4310.25,4314.25,13,/Date(1643308320000)/,3014,3552,0,0,1578,1852,0,2022-01-27 13:32:00
4310.0,1702,2175,4317.5,4308.75,4317.0,13,/Date(1643308380000)/,3019,3699,0,0,1317,1524,0,2022-01-27 13:33:00
4312.25,1221,1361,4314.25,4308.25,4309.75,13,/Date(1643308440000)/,2651,3265,0,0,1430,1904,0,2022-01-27 13:34:00
4317.0,1431,1794,4317.5,4312.0,4312.25,13,/Date(1643308500000)/,3164,3976,0,0,1733,2182,0,2022-01-27 13:35:00
4323.5,2389,2745,4323.5,4313.5,4316.75,13,/Date(1643308560000)/,5147,6394,0,0,2758,3649,0,2022-01-27 13:36:00
4317.5,2139,2672,4324.25,4315.0,4323.5,13,/Date(1643308620000)/,4117,5115,0,0,1978,2443,0,2022-01-27 13:37:00
4313.75,1490,1844,4317.75,4312.0,4317.25,13,/Date(1643308680000)/,2729,3330,0,0,1239,1486,0,2022-01-27 13:38:00
4312.25,1138,1350,4316.75,4311.25,4313.5,13,/Date(1643308740000)/,2262,2731,0,0,1124,1381,0,2022-01-27 13:39:00
4309.25,1331,1654,4313.25,4308.0,4312.0,13,/Date(1643308800000)/,2436,2980,0,0,1105,1326,0,2022-01-27 13:40:00
4309.25,1385,1699,4310.75,4305.25,4309.0,13,/Date(1643308860000)/,2762,3380,0,0,1377,1681,0,2022-01-27 13:41:00
4312.5,1462,1705,4314.25,4308.5,4309.25,13,/Date(1643308920000)/,2912,3519,0,0,1450,1814,0,2022-01-27 13:42:00
4315.0,1626,2007,4319.5,4312.5,4312.5,13,/Date(1643308980000)/,3420,4232,0,0,1794,2225,0,2022-01-27 13:43:00
4309.75,1603,1884,4315.0,4306.5,4314.75,13,/Date(1643309040000)/,2951,3515,0,0,1348,1631,0,2022-01-27 13:44:00
4315.5,1252,1372,4316.0,4306.5,4309.75,13,/Date(1643309100000)/,2724,3068,0,0,1472,1696,0,2022-01-27 13:45:00
4313.0,1521,1806,4316.5,4309.75,4315.5,13,/Date(1643309160000)/,2715,3233,0,0,1194,1427,0,2022-01-27 13:46:00
4315.0,1529,1717,4317.5,4310.0,4313.0,13,/Date(1643309220000)/,2980,3452,0,0,1451,1735,0,2022-01-27 13:47:00
4314.0,954,1061,4315.75,4311.25,4315.0,13,/Date(1643309280000)/,1902,2124,0,0,948,1063,0,2022-01-27 13:48:00
4318.5,969,1089,4319.25,4311.0,4313.75,13,/Date(1643309340000)/,2052,2423,0,0,1083,1334,0,2022-01-27 13:49:00
4320.0,1455,1760,4321.75,4316.0,4318.25,13,/Date(1643309400000)/,3078,3821,0,0,1623,2061,0,2022-01-27 13:50:00
4316.0,2022,2521,4322.0,4315.0,4319.75,13,/Date(1643309460000)/,3707,4598,0,0,1685,2077,0,2022-01-27 13:51:00
4312.75,1253,1387,4316.5,4312.0,4316.0,13,/Date(1643309520000)/,2418,2914,0,0,1165,1527,0,2022-01-27 13:52:00
4312.75,1195,1490,4314.25,4310.0,4312.75,13,/Date(1643309580000)/,2349,2890,0,0,1154,1400,0,2022-01-27 13:53:00
4314.5,745,846,4316.25,4312.25,4313.0,13,/Date(1643309640000)/,1576,1885,0,0,831,1039,0,2022-01-27 13:54:00
4313.25,800,1034,4314.75,4311.75,4314.0,13,/Date(1643309700000)/,1673,2101,0,0,873,1067,0,2022-01-27 13:55:00
4313.75,818,974,4315.0,4310.75,4313.0,13,/Date(1643309760000)/,1744,2195,0,0,926,1221,0,2022-01-27 13:56:00
4316.0,1388,1685,4317.75,4313.0,4313.5,13,/Date(1643309820000)/,2918,3692,0,0,1530,2007,0,2022-01-27 13:57:00
4327.5,2459,3058,4327.75,4314.75,4315.75,13,/Date(1643309880000)/,5183,7095,0,0,2724,4037,0,2022-01-27 13:58:00
4326.25,2394,3068,4329.75,4324.5,4327.25,13,/Date(1643309940000)/,4500,5718,0,0,2106,2650,0,2022-01-27 13:59:00
4324.75,1934,2517,4326.75,4323.0,4326.0,13,/Date(1643310000000)/,3686,4897,0,0,1752,2380,0,2022-01-27 14:00:00
4332.0,2021,2533,4332.5,4322.75,4324.5,13,/Date(1643310060000)/,4505,6000,0,0,2484,3467,0,2022-01-27 14:01:00
4337.0,1778,2250,4337.5,4331.75,4331.75,13,/Date(1643310120000)/,3835,4886,0,0,2057,2636,0,2022-01-27 14:02:00
4336.75,1906,2754,4340.75,4335.5,4336.75,13,/Date(1643310180000)/,4167,5828,0,0,2261,3074,0,2022-01-27 14:03:00
4341.25,1003,1210,4341.25,4334.75,4336.5,13,/Date(1643310240000)/,2282,2987,0,0,1279,1777,0,2022-01-27 14:04:00
4338.75,1370,1709,4343.0,4337.75,4341.25,13,/Date(1643310300000)/,2645,3367,0,0,1275,1658,0,2022-01-27 14:05:00
4339.25,930,1074,4341.25,4337.0,4338.75,13,/Date(1643310360000)/,1905,2352,0,0,975,1278,0,2022-01-27 14:06:00
4339.25,2397,3046,4347.5,4338.5,4339.0,13,/Date(1643310420000)/,4840,6567,0,0,2443,3521,0,2022-01-27 14:07:00
4335.5,2522,3148,4339.75,4331.75,4339.0,13,/Date(1643310480000)/,4268,5335,0,0,1746,2187,0,2022-01-27 14:08:00
4337.25,1331,1618,4339.5,4334.75,4335.5,13,/Date(1643310540000)/,2624,3213,0,0,1293,1595,0,2022-01-27 14:09:00
4337.0,940,1110,4339.25,4336.0,4337.0,13,/Date(1643310600000)/,1740,2126,0,0,800,1016,0,2022-01-27 14:10:00
4335.0,1595,1881,4343.0,4334.5,4337.0,13,/Date(1643310660000)/,3110,3890,0,0,1515,2009,0,2022-01-27 14:11:00
4338.0,982,1103,4340.0,4334.75,4335.25,13,/Date(1643310720000)/,2044,2378,0,0,1062,1275,0,2022-01-27 14:12:00
4337.0,938,1109,4339.75,4335.5,4337.75,13,/Date(1643310780000)/,1942,2339,0,0,1004,1230,0,2022-01-27 14:13:00
4334.75,1176,1421,4337.0,4332.75,4337.0,13,/Date(1643310840000)/,2172,2619,0,0,996,1198,0,2022-01-27 14:14:00
4334.0,835,971,4338.0,4333.0,4334.5,13,/Date(1643310900000)/,1630,1951,0,0,795,980,0,2022-01-27 14:15:00
4329.25,1983,2558,4335.75,4326.5,4334.0,13,/Date(1643310960000)/,3580,4475,0,0,1597,1917,0,2022-01-27 14:16:00
4326.0,1589,1936,4331.0,4324.75,4329.75,13,/Date(1643311020000)/,2985,3581,0,0,1396,1645,0,2022-01-27 14:17:00
4326.5,750,845,4329.5,4325.25,4325.75,13,/Date(1643311080000)/,1518,1817,0,0,768,972,0,2022-01-27 14:18:00
4325.0,1248,1608,4328.5,4322.0,4326.5,13,/Date(1643311140000)/,2514,3138,0,0,1266,1530,0,2022-01-27 14:19:00
4326.0,819,974,4328.0,4324.75,4324.75,13,/Date(1643311200000)/,1578,1894,0,0,759,920,0,2022-01-27 14:20:00
4323.25,1125,1399,4326.75,4322.25,4326.0,13,/Date(1643311260000)/,2361,2823,0,0,1236,1424,0,2022-01-27 14:21:00
4322.25,1323,1847,4323.75,4319.25,4323.25,13,/Date(1643311320000)/,2456,3291,0,0,1133,1444,0,2022-01-27 14:22:00
4321.5,894,1157,4323.75,4320.0,4322.5,13,/Date(1643311380000)/,1692,2105,0,0,798,948,0,2022-01-27 14:23:00
4323.25,838,993,4323.75,4320.0,4321.5,13,/Date(1643311440000)/,1693,1995,0,0,855,1002,0,2022-01-27 14:24:00
4313.25,2583,3415,4323.5,4312.25,4323.0,13,/Date(1643311500000)/,4464,5749,0,0,1881,2334,0,2022-01-27 14:25:00
4316.25,1133,1281,4317.0,4311.5,4313.25,13,/Date(1643311560000)/,2408,2785,0,0,1275,1504,0,2022-01-27 14:26:00
4311.5,1087,1414,4317.5,4311.0,4316.25,13,/Date(1643311620000)/,2059,2568,0,0,972,1154,0,2022-01-27 14:27:00
4312.75,1085,1253,4316.0,4311.5,4311.5,13,/Date(1643311680000)/,2164,2612,0,0,1079,1359,0,2022-01-27 14:28:00
4311.25,1059,1232,4315.0,4310.5,4312.75,13,/Date(1643311740000)/,1988,2271,0,0,929,1039,0,2022-01-27 14:29:00
4313.5,903,1088,4315.0,4310.0,4311.25,13,/Date(1643311800000)/,1808,2203,0,0,905,1115,0,2022-01-27 14:30:00
4316.5,902,1073,4317.0,4311.75,4313.5,13,/Date(1643311860000)/,1750,2075,0,0,848,1002,0,2022-01-27 14:31:00
4317.25,1021,1221,4319.75,4314.25,4316.25,13,/Date(1643311920000)/,2178,2791,0,0,1157,1570,0,2022-01-27 14:32:00
4307.5,1701,2519,4317.25,4307.0,4317.25,13,/Date(1643311980000)/,3003,4076,0,0,1302,1557,0,2022-01-27 14:33:00
4305.0,2429,3208,4310.0,4303.25,4307.5,13,/Date(1643312040000)/,4692,5889,0,0,2263,2681,0,2022-01-27 14:34:00
4307.5,1421,1727,4309.5,4304.75,4305.0,13,/Date(1643312100000)/,2952,3495,0,0,1531,1768,0,2022-01-27 14:35:00
4312.25,1974,2386,4317.25,4306.25,4307.75,13,/Date(1643312160000)/,4148,4960,0,0,2174,2574,0,2022-01-27 14:36:00
4314.5,1274,1435,4316.5,4312.25,4312.5,13,/Date(1643312220000)/,2641,3067,0,0,1367,1632,0,2022-01-27 14:37:00
4315.75,1473,1707,4318.75,4312.75,4314.75,13,/Date(1643312280000)/,3012,3550,0,0,1539,1843,0,2022-01-27 14:38:00
4313.75,1222,1530,4317.0,4312.5,4315.75,13,/Date(1643312340000)/,2365,2785,0,0,1143,1255,0,2022-01-27 14:39:00
4317.5,845,981,4318.0,4312.75,4314.0,13,/Date(1643312400000)/,1812,2183,0,0,967,1202,0,2022-01-27 14:40:00
4327.5,2158,2596,4330.0,4315.75,4317.25,13,/Date(1643312460000)/,4765,5823,0,0,2607,3227,0,2022-01-27 14:41:00
4325.75,1035,1195,4328.75,4325.25,4327.0,13,/Date(1643312520000)/,2022,2331,0,0,987,1136,0,2022-01-27 14:42:00
4326.0,1460,1750,4330.5,4323.5,4325.75,13,/Date(1643312580000)/,2907,3584,0,0,1447,1834,0,2022-01-27 14:43:00
4327.25,968,1159,4327.75,4324.0,4326.0,13,/Date(1643312640000)/,1782,2089,0,0,814,930,0,2022-01-27 14:44:00
4328.0,813,968,4328.75,4325.0,4327.0,13,/Date(1643312700000)/,1667,2006,0,0,854,1038,0,2022-01-27 14:45:00
4331.75,1563,1842,4334.25,4326.0,4328.0,13,/Date(1643312760000)/,3336,4058,0,0,1773,2216,0,2022-01-27 14:46:00
4333.75,973,1077,4334.75,4331.0,4331.5,13,/Date(1643312820000)/,2130,2559,0,0,1157,1482,0,2022-01-27 14:47:00
4330.25,1044,1240,4334.0,4328.75,4334.0,13,/Date(1643312880000)/,1939,2365,0,0,895,1125,0,2022-01-27 14:48:00
4325.0,1520,1962,4331.0,4322.75,4330.5,13,/Date(1643312940000)/,2494,3184,0,0,974,1222,0,2022-01-27 14:49:00
4326.5,849,968,4327.75,4324.75,4325.25,13,/Date(1643313000000)/,1737,2005,0,0,888,1037,0,2022-01-27 14:50:00
4321.5,1488,1797,4326.75,4321.5,4326.25,13,/Date(1643313060000)/,2690,3181,0,0,1202,1384,0,2022-01-27 14:51:00
4320.5,1387,1674,4321.5,4317.0,4321.5,13,/Date(1643313120000)/,2710,3233,0,0,1323,1559,0,2022-01-27 14:52:00
4319.25,1131,1312,4324.25,4318.0,4320.5,13,/Date(1643313180000)/,2160,2553,0,0,1029,1241,0,2022-01-27 14:53:00
4313.5,1581,1821,4319.75,4311.5,4319.5,13,/Date(1643313240000)/,2968,3505,0,0,1387,1684,0,2022-01-27 14:54:00
4312.0,1340,1679,4315.75,4310.5,4313.75,13,/Date(1643313300000)/,2476,3035,0,0,1136,1356,0,2022-01-27 14:55:00
4308.5,1773,2197,4313.75,4306.25,4312.0,13,/Date(1643313360000)/,3191,3864,0,0,1418,1667,0,2022-01-27 14:56:00
4311.0,1171,1481,4312.25,4306.5,4308.25,13,/Date(1643313420000)/,2555,3341,0,0,1384,1860,0,2022-01-27 14:57:00
4314.25,892,1010,4316.25,4310.25,4311.5,13,/Date(1643313480000)/,1948,2368,0,0,1056,1358,0,2022-01-27 14:58:00
4317.5,1433,1794,4320.0,4313.0,4314.0,13,/Date(1643313540000)/,3105,4074,0,0,1672,2280,0,2022-01-27 14:59:00
4316.0,1107,1315,4317.5,4313.25,4317.5,13,/Date(1643313600000)/,2348,2864,0,0,1241,1549,0,2022-01-27 15:00:00
4323.5,2194,2690,4324.75,4315.0,4316.25,13,/Date(1643313660000)/,4485,5726,0,0,2291,3036,0,2022-01-27 15:01:00
4322.5,1002,1281,4324.5,4321.5,4323.75,13,/Date(1643313720000)/,1869,2281,0,0,867,1000,0,2022-01-27 15:02:00
4328.0,1706,2174,4329.5,4321.75,4322.75,13,/Date(1643313780000)/,3931,4986,0,0,2225,2812,0,2022-01-27 15:03:00
4327.0,1377,1766,4331.0,4323.75,4327.75,13,/Date(1643313840000)/,2863,3547,0,0,1486,1781,0,2022-01-27 15:04:00
4323.75,1037,1293,4327.25,4321.0,4326.75,13,/Date(1643313900000)/,1872,2251,0,0,835,958,0,2022-01-27 15:05:00
4324.25,1199,1499,4325.75,4320.0,4323.75,13,/Date(1643313960000)/,2384,2873,0,0,1185,1374,0,2022-01-27 15:06:00
4325.5,1224,1455,4328.75,4322.75,4324.0,13,/Date(1643314020000)/,2514,3139,0,0,1290,1684,0,2022-01-27 15:07:00
4326.0,1081,1290,4328.0,4324.5,4325.5,13,/Date(1643314080000)/,1913,2257,0,0,832,967,0,2022-01-27 15:08:00
4329.0,1439,1627,4332.25,4325.25,4326.0,13,/Date(1643314140000)/,2871,3377,0,0,1432,1750,0,2022-01-27 15:09:00
4318.75,2114,2655,4330.25,4317.0,4329.25,13,/Date(1643314200000)/,3753,4603,0,0,1639,1948,0,2022-01-27 15:10:00
4315.0,1571,1890,4321.5,4314.25,4319.0,13,/Date(1643314260000)/,2937,3445,0,0,1366,1555,0,2022-01-27 15:11:00
4312.5,1265,1456,4315.75,4312.0,4315.0,13,/Date(1643314320000)/,2320,2697,0,0,1055,1241,0,2022-01-27 15:12:00
4313.5,1353,1691,4317.25,4311.25,4312.25,13,/Date(1643314380000)/,2843,3533,0,0,1490,1842,0,2022-01-27 15:13:00
4305.75,1995,2643,4314.0,4305.5,4313.75,13,/Date(1643314440000)/,3541,4497,0,0,1546,1854,0,2022-01-27 15:14:00
4307.5,1372,1609,4308.5,4305.25,4305.75,13,/Date(1643314500000)/,2901,3449,0,0,1529,1840,0,2022-01-27 15:15:00
4302.25,3332,4591,4309.0,4298.75,4307.25,13,/Date(1643314560000)/,6057,8078,0,0,2725,3487,0,2022-01-27 15:16:00
4305.25,1558,1929,4306.75,4301.0,4302.0,13,/Date(1643314620000)/,3303,4098,0,0,1745,2169,0,2022-01-27 15:17:00
4305.25,1472,1830,4308.25,4303.25,4305.0,13,/Date(1643314680000)/,2988,3704,0,0,1516,1874,0,2022-01-27 15:18:00
4306.0,998,1302,4308.25,4304.75,4305.25,13,/Date(1643314740000)/,2178,2700,0,0,1180,1398,0,2022-01-27 15:19:00
4313.75,1265,1674,4314.0,4305.25,4305.75,13,/Date(1643314800000)/,3341,4272,0,0,2076,2598,0,2022-01-27 15:20:00
4312.0,1713,1988,4318.25,4309.75,4313.75,13,/Date(1643314860000)/,3358,3875,0,0,1645,1887,0,2022-01-27 15:21:00
4305.25,1488,1766,4312.0,4302.75,4312.0,13,/Date(1643314920000)/,2825,3398,0,0,1337,1632,0,2022-01-27 15:22:00
4306.25,1104,1611,4307.75,4304.5,4305.0,13,/Date(1643314980000)/,2213,2893,0,0,1109,1282,0,2022-01-27 15:23:00
4307.25,714,967,4308.75,4305.0,4306.25,13,/Date(1643315040000)/,1556,1983,0,0,842,1016,0,2022-01-27 15:24:00
4311.5,1181,1482,4314.0,4305.25,4307.25,13,/Date(1643315100000)/,2701,3288,0,0,1520,1806,0,2022-01-27 15:25:00
4312.5,1126,1331,4316.5,4311.25,4311.75,13,/Date(1643315160000)/,2409,2912,0,0,1283,1581,0,2022-01-27 15:26:00
4316.25,1406,1777,4319.0,4310.5,4312.25,13,/Date(1643315220000)/,3005,3752,0,0,1599,1975,0,2022-01-27 15:27:00
4323.0,1685,2048,4324.5,4315.75,4316.25,13,/Date(1643315280000)/,3612,4733,0,0,1927,2685,0,2022-01-27 15:28:00
4322.0,939,1131,4324.0,4321.5,4322.75,13,/Date(1643315340000)/,1754,2167,0,0,815,1036,0,2022-01-27 15:29:00
4320.75,1014,1390,4323.25,4319.5,4322.5,13,/Date(1643315400000)/,1965,2551,0,0,951,1161,0,2022-01-27 15:30:00
4321.25,1529,1760,4324.75,4320.25,4320.75,13,/Date(1643315460000)/,3207,3920,0,0,1678,2160,0,2022-01-27 15:31:00
4320.25,1738,2423,4321.75,4317.75,4321.5,13,/Date(1643315520000)/,3138,4250,0,0,1400,1827,0,2022-01-27 15:32:00
4325.75,1137,1373,4326.5,4318.5,4320.75,13,/Date(1643315580000)/,2783,3555,0,0,1646,2182,0,2022-01-27 15:33:00
4320.0,2074,2732,4329.5,4319.0,4325.75,13,/Date(1643315640000)/,4083,5253,0,0,2009,2521,0,2022-01-27 15:34:00
4319.75,1194,1744,4323.0,4317.75,4320.0,13,/Date(1643315700000)/,2508,3253,0,0,1314,1509,0,2022-01-27 15:35:00
4321.75,1240,1437,4324.5,4319.5,4320.0,13,/Date(1643315760000)/,2493,2858,0,0,1253,1421,0,2022-01-27 15:36:00
4319.0,1193,1574,4323.5,4318.5,4321.5,13,/Date(1643315820000)/,2304,2897,0,0,1111,1323,0,2022-01-27 15:37:00
4319.25,1193,1628,4321.25,4317.25,4318.75,13,/Date(1643315880000)/,2303,2977,0,0,1110,1349,0,2022-01-27 15:38:00
4313.0,1611,2742,4319.5,4313.0,4319.0,13,/Date(1643315940000)/,2612,3971,0,0,1001,1229,0,2022-01-27 15:39:00
4316.0,1044,1261,4317.25,4312.5,4313.0,13,/Date(1643316000000)/,2207,2649,0,0,1163,1388,0,2022-01-27 15:40:00
4318.0,1033,1475,4318.25,4314.0,4316.25,13,/Date(1643316060000)/,2128,2841,0,0,1095,1366,0,2022-01-27 15:41:00
4328.25,1858,2293,4329.0,4317.0,4318.25,13,/Date(1643316120000)/,4198,5185,0,0,2340,2892,0,2022-01-27 15:42:00
4334.0,1885,2288,4334.25,4327.75,4328.5,13,/Date(1643316180000)/,4060,5231,0,0,2175,2943,0,2022-01-27 15:43:00
4335.5,2041,2584,4337.75,4333.25,4334.0,13,/Date(1643316240000)/,4134,5447,0,0,2093,2863,0,2022-01-27 15:44:00
4333.75,1815,2112,4336.75,4330.5,4335.5,13,/Date(1643316300000)/,3485,4305,0,0,1670,2193,0,2022-01-27 15:45:00
4338.25,2039,2400,4339.0,4333.75,4334.0,13,/Date(1643316360000)/,4543,6172,0,0,2504,3772,0,2022-01-27 15:46:00
4342.0,2244,2964,4344.75,4338.25,4338.25,13,/Date(1643316420000)/,5046,7420,0,0,2802,4456,0,2022-01-27 15:47:00
4333.0,3031,3953,4342.25,4329.0,4341.75,13,/Date(1643316480000)/,5677,6997,0,0,2646,3044,0,2022-01-27 15:48:00
4326.0,2385,3257,4333.25,4323.5,4333.0,13,/Date(1643316540000)/,4531,5649,0,0,2146,2392,0,2022-01-27 15:49:00
4327.75,2158,2865,4331.0,4323.0,4325.75,13,/Date(1643316600000)/,4828,6090,0,0,2670,3225,0,2022-01-27 15:50:00
4323.5,3890,5197,4328.75,4321.5,4328.0,13,/Date(1643316660000)/,7500,9479,0,0,3610,4282,0,2022-01-27 15:51:00
4323.5,1754,2132,4325.5,4321.5,4323.5,13,/Date(1643316720000)/,3652,4376,0,0,1898,2244,0,2022-01-27 15:52:00
4326.25,1570,1890,4326.75,4323.0,4323.5,13,/Date(1643316780000)/,3358,4001,0,0,1788,2111,0,2022-01-27 15:53:00
4323.75,1370,1717,4328.0,4322.75,4326.0,13,/Date(1643316840000)/,2916,3665,0,0,1546,1948,0,2022-01-27 15:54:00
4323.25,1310,1822,4324.0,4321.5,4323.75,13,/Date(1643316900000)/,2685,3716,0,0,1375,1894,0,2022-01-27 15:55:00
4325.25,2271,2697,4327.5,4322.25,4323.0,13,/Date(1643316960000)/,4703,5841,0,0,2432,3144,0,2022-01-27 15:56:00
4321.0,1774,2568,4325.25,4320.5,4325.0,13,/Date(1643317020000)/,3299,4591,0,0,1525,2023,0,2022-01-27 15:57:00
4322.5,2409,3660,4323.25,4318.5,4321.0,13,/Date(1643317080000)/,4528,6574,0,0,2119,2914,0,2022-01-27 15:58:00
4319.75,2599,3956,4322.75,4319.25,4322.5,13,/Date(1643317140000)/,4854,7204,0,0,2255,3248,0,2022-01-27 15:59:00
4317.75,8386,20990,4321.0,4315.0,4319.75,13,/Date(1643317200000)/,16702,41669,0,0,8316,20679,0,2022-01-27 16:00:00
4319.25,3793,7257,4320.75,4315.0,4318.0,13,/Date(1643317260000)/,7556,14036,0,0,3763,6779,0,2022-01-27 16:01:00
4318.5,1140,1527,4319.25,4317.0,4319.25,13,/Date(1643317320000)/,2093,3112,0,0,953,1585,0,2022-01-27 16:02:00
4315.5,1208,2111,4319.25,4315.5,4318.75,13,/Date(1643317380000)/,2394,3957,0,0,1186,1846,0,2022-01-27 16:03:00
4315.5,759,1302,4317.5,4315.25,4315.75,13,/Date(1643317440000)/,1610,2610,0,0,851,1308,0,2022-01-27 16:04:00
4318.25,993,1473,4318.25,4312.75,4315.5,13,/Date(1643317500000)/,1920,2808,0,0,927,1335,0,2022-01-27 16:05:00
4325.0,1685,2195,4325.5,4316.5,4318.25,13,/Date(1643317560000)/,3597,5222,0,0,1912,3027,0,2022-01-27 16:06:00
4325.0,904,1133,4327.25,4321.75,4325.0,13,/Date(1643317620000)/,1741,2440,0,0,837,1307,0,2022-01-27 16:07:00
4322.75,561,685,4325.75,4322.25,4325.25,13,/Date(1643317680000)/,985,1243,0,0,424,558,0,2022-01-27 16:08:00
4322.25,474,570,4324.0,4321.5,4323.0,13,/Date(1643317740000)/,826,1089,0,0,352,519,0,2022-01-27 16:09:00
4323.5,343,451,4324.25,4321.5,4322.25,13,/Date(1643317800000)/,649,893,0,0,306,442,0,2022-01-27 16:10:00
4322.25,321,418,4324.0,4321.75,4323.5,13,/Date(1643317860000)/,544,750,0,0,223,332,0,2022-01-27 16:11:00
4318.75,487,613,4323.0,4317.75,4322.5,13,/Date(1643317920000)/,884,1129,0,0,397,516,0,2022-01-27 16:12:00
4318.25,693,1052,4320.75,4316.5,4318.75,13,/Date(1643317980000)/,1281,1865,0,0,588,813,0,2022-01-27 16:13:00
4327.25,941,1138,4327.5,4317.25,4318.0,13,/Date(1643318040000)/,1964,2720,0,0,1023,1582,0,2022-01-27 16:14:00
4323.25,1011,1323,4328.25,4323.0,4327.0,13,/Date(1643318100000)/,1775,2543,0,0,764,1220,0,2022-01-27 16:15:00
4323.0,230,307,4325.0,4322.5,4323.0,13,/Date(1643318160000)/,457,590,0,0,227,283,0,2022-01-27 16:16:00
4325.0,134,173,4326.0,4322.75,4323.25,13,/Date(1643318220000)/,333,507,0,0,199,334,0,2022-01-27 16:17:00
4323.75,184,226,4325.75,4323.25,4325.25,13,/Date(1643318280000)/,306,453,0,0,122,227,0,2022-01-27 16:18:00
4327.25,105,243,4327.75,4323.5,4323.75,13,/Date(1643318340000)/,270,457,0,0,165,214,0,2022-01-27 16:19:00
4328.0,97,122,4328.5,4325.5,4327.25,13,/Date(1643318400000)/,205,290,0,0,108,168,0,2022-01-27 16:20:00
4324.0,292,443,4329.0,4323.5,4328.5,13,/Date(1643318460000)/,396,578,0,0,104,135,0,2022-01-27 16:21:00
4321.75,156,206,4324.5,4320.75,4324.0,13,/Date(1643318520000)/,224,294,0,0,68,88,0,2022-01-27 16:22:00
4324.5,126,156,4326.25,4322.0,4322.0,13,/Date(1643318580000)/,269,329,0,0,143,173,0,2022-01-27 16:23:00
4324.0,74,128,4325.75,4323.25,4324.75,13,/Date(1643318640000)/,174,301,0,0,100,173,0,2022-01-27 16:24:00
4321.5,141,159,4324.25,4320.25,4323.75,13,/Date(1643318700000)/,222,254,0,0,81,95,0,2022-01-27 16:25:00
4324.0,98,113,4324.25,4320.0,4321.0,13,/Date(1643318760000)/,195,261,0,0,97,148,0,2022-01-27 16:26:00
4323.25,53,66,4325.0,4323.0,4324.25,13,/Date(1643318820000)/,133,209,0,0,80,143,0,2022-01-27 16:27:00
4324.0,82,129,4324.0,4322.25,4323.0,13,/Date(1643318880000)/,196,278,0,0,114,149,0,2022-01-27 16:28:00
4322.0,160,201,4324.5,4321.0,4324.0,13,/Date(1643318940000)/,261,326,0,0,101,125,0,2022-01-27 16:29:00
4323.25,64,74,4323.75,4322.0,4322.0,13,/Date(1643319000000)/,139,154,0,0,75,80,0,2022-01-27 16:30:00
4331.25,1593,2031,4336.0,4315.0,4323.25,13,/Date(1643319060000)/,3253,4411,0,0,1660,2380,0,2022-01-27 16:31:00
4333.25,478,643,4335.0,4330.25,4331.75,13,/Date(1643319120000)/,973,1398,0,0,495,755,0,2022-01-27 16:32:00
4335.75,357,584,4335.75,4329.5,4333.0,13,/Date(1643319180000)/,778,1503,0,0,421,919,0,2022-01-27 16:33:00
4338.75,313,585,4339.5,4335.25,4335.75,13,/Date(1643319240000)/,805,1530,0,0,492,945,0,2022-01-27 16:34:00
4332.5,684,1110,4340.0,4331.0,4338.75,13,/Date(1643319300000)/,1269,2073,0,0,585,963,0,2022-01-27 16:35:00
4331.5,343,459,4335.0,4329.0,4332.75,13,/Date(1643319360000)/,678,851,0,0,335,392,0,2022-01-27 16:36:00
4334.25,152,205,4334.5,4331.5,4331.75,13,/Date(1643319420000)/,351,596,0,0,199,391,0,2022-01-27 16:37:00
4332.0,251,385,4334.75,4329.5,4333.75,13,/Date(1643319480000)/,491,794,0,0,240,409,0,2022-01-27 16:38:00
4330.5,131,206,4332.25,4329.0,4332.0,13,/Date(1643319540000)/,262,356,0,0,131,150,0,2022-01-27 16:39:00
4335.0,182,263,4335.25,4330.0,4330.25,13,/Date(1643319600000)/,484,694,0,0,302,431,0,2022-01-27 16:40:00
4337.0,224,282,4337.25,4332.25,4335.25,13,/Date(1643319660000)/,544,756,0,0,320,474,0,2022-01-27 16:41:00
4337.25,197,303,4338.5,4335.75,4337.0,13,/Date(1643319720000)/,437,636,0,0,240,333,0,2022-01-27 16:42:00
4341.25,275,433,4341.25,4337.5,4337.5,13,/Date(1643319780000)/,692,1273,0,0,417,840,0,2022-01-27 16:43:00
4337.5,243,374,4341.5,4337.5,4341.0,13,/Date(1643319840000)/,394,659,0,0,151,285,0,2022-01-27 16:44:00
4339.25,97,151,4340.0,4337.75,4338.0,13,/Date(1643319900000)/,221,403,0,0,124,252,0,2022-01-27 16:45:00
4342.25,144,191,4342.75,4338.25,4339.0,13,/Date(1643319960000)/,410,703,0,0,266,512,0,2022-01-27 16:46:00
4341.5,187,241,4343.5,4340.75,4342.25,13,/Date(1643320020000)/,416,561,0,0,229,320,0,2022-01-27 16:47:00
4341.0,136,183,4342.75,4340.5,4341.75,13,/Date(1643320080000)/,256,349,0,0,120,166,0,2022-01-27 16:48:00
4340.0,97,143,4341.5,4339.75,4341.0,13,/Date(1643320140000)/,181,237,0,0,84,94,0,2022-01-27 16:49:00
4339.5,234,359,4340.75,4337.5,4340.0,13,/Date(1643320200000)/,409,610,0,0,175,251,0,2022-01-27 16:50:00
4337.75,227,328,4340.25,4337.25,4339.5,13,/Date(1643320260000)/,360,521,0,0,133,193,0,2022-01-27 16:51:00
4338.75,126,190,4339.0,4336.5,4337.5,13,/Date(1643320320000)/,268,369,0,0,142,179,0,2022-01-27 16:52:00
4338.5,93,149,4339.5,4337.75,4338.25,13,/Date(1643320380000)/,222,385,0,0,129,236,0,2022-01-27 16:53:00
4340.25,72,142,4340.5,4338.0,4338.25,13,/Date(1643320440000)/,250,447,0,0,178,305,0,2022-01-27 16:54:00
4339.25,191,274,4342.0,4338.75,4340.0,13,/Date(1643320500000)/,342,495,0,0,151,221,0,2022-01-27 16:55:00
4342.75,76,98,4342.75,4339.25,4339.75,13,/Date(1643320560000)/,225,340,0,0,149,242,0,2022-01-27 16:56:00
4343.75,69,109,4344.75,4341.5,4342.75,13,/Date(1643320620000)/,225,339,0,0,156,230,0,2022-01-27 16:57:00
4341.75,106,167,4344.0,4341.75,4343.75,13,/Date(1643320680000)/,161,246,0,0,55,79,0,2022-01-27 16:58:00
4342.25,142,239,4343.25,4341.25,4341.75,13,/Date(1643320740000)/,287,481,0,0,145,242,0,2022-01-27 16:59:00
4344.0,73,101,4344.25,4342.0,4342.0,29,/Date(1643320800000)/,179,288,0,0,106,187,0,2022-01-27 17:00:00
4349.0,479,660,4352.25,4347.25,4348.0,13,/Date(1643324460000)/,1096,2329,0,0,617,1669,0,2022-01-27 18:01:00
4345.75,441,670,4349.75,4345.25,4349.0,13,/Date(1643324520000)/,749,1105,0,0,308,435,0,2022-01-27 18:02:00
4347.75,137,238,4348.5,4345.25,4346.0,13,/Date(1643324580000)/,321,513,0,0,184,275,0,2022-01-27 18:03:00
4347.0,138,175,4347.75,4345.25,4347.5,13,/Date(1643324640000)/,263,363,0,0,125,188,0,2022-01-27 18:04:00
4347.25,39,59,4347.75,4347.0,4347.0,13,/Date(1643324700000)/,90,140,0,0,51,81,0,2022-01-27 18:05:00
4348.75,110,127,4349.25,4347.0,4347.5,13,/Date(1643324760000)/,265,423,0,0,155,296,0,2022-01-27 18:06:00
4349.5,65,73,4349.75,4348.5,4349.0,13,/Date(1643324820000)/,133,183,0,0,68,110,0,2022-01-27 18:07:00
4351.0,94,110,4352.25,4349.25,4349.5,13,/Date(1643324880000)/,300,420,0,0,206,310,0,2022-01-27 18:08:00
4352.0,76,96,4353.0,4350.75,4351.25,13,/Date(1643324940000)/,233,357,0,0,157,261,0,2022-01-27 18:09:00
4350.5,130,154,4352.75,4350.5,4352.25,13,/Date(1643325000000)/,176,216,0,0,46,62,0,2022-01-27 18:10:00
4351.5,119,145,4352.75,4350.5,4350.5,13,/Date(1643325060000)/,251,317,0,0,132,172,0,2022-01-27 18:11:00
4353.0,78,128,4353.0,4350.5,4351.5,13,/Date(1643325120000)/,171,260,0,0,93,132,0,2022-01-27 18:12:00
4353.5,76,86,4353.75,4352.5,4352.75,13,/Date(1643325180000)/,194,304,0,0,118,218,0,2022-01-27 18:13:00
4352.5,121,165,4353.25,4351.5,4353.25,13,/Date(1643325240000)/,190,270,0,0,69,105,0,2022-01-27 18:14:00
4352.0,92,107,4352.25,4351.0,4352.25,13,/Date(1643325300000)/,148,188,0,0,56,81,0,2022-01-27 18:15:00
4348.0,181,225,4351.75,4347.5,4351.75,13,/Date(1643325360000)/,265,324,0,0,84,99,0,2022-01-27 18:16:00
4346.0,156,209,4348.5,4345.5,4348.25,13,/Date(1643325420000)/,254,325,0,0,98,116,0,2022-01-27 18:17:00
4346.25,66,77,4346.75,4345.5,4345.5,13,/Date(1643325480000)/,166,219,0,0,100,142,0,2022-01-27 18:18:00
4343.0,248,353,4347.0,4342.75,4346.25,13,/Date(1643325540000)/,453,626,0,0,205,273,0,2022-01-27 18:19:00
4342.0,165,198,4343.75,4341.75,4343.0,13,/Date(1643325600000)/,316,373,0,0,151,175,0,2022-01-27 18:20:00
4344.25,84,93,4345.0,4342.25,4342.25,13,/Date(1643325660000)/,288,350,0,0,204,257,0,2022-01-27 18:21:00
4344.25,56,61,4344.75,4343.25,4344.25,13,/Date(1643325720000)/,157,177,0,0,101,116,0,2022-01-27 18:22:00
4346.75,82,90,4347.25,4343.75,4344.0,13,/Date(1643325780000)/,256,290,0,0,174,200,0,2022-01-27 18:23:00
4345.25,89,94,4347.0,4344.75,4346.75,13,/Date(1643325840000)/,160,184,0,0,71,90,0,2022-01-27 18:24:00
4349.0,145,172,4350.0,4345.0,4345.0,13,/Date(1643325900000)/,408,513,0,0,263,341,0,2022-01-27 18:25:00
4351.0,145,161,4351.5,4349.0,4349.0,13,/Date(1643325960000)/,339,401,0,0,194,240,0,2022-01-27 18:26:00
4350.0,157,194,4350.75,4348.25,4350.75,13,/Date(1643326020000)/,300,376,0,0,143,182,0,2022-01-27 18:27:00
4349.25,199,267,4352.75,4349.25,4350.0,13,/Date(1643326080000)/,419,532,0,0,220,265,0,2022-01-27 18:28:00
4350.75,68,73,4351.25,4348.75,4349.25,13,/Date(1643326140000)/,174,212,0,0,106,139,0,2022-01-27 18:29:00
4348.5,67,70,4351.25,4348.25,4351.0,13,/Date(1643326200000)/,122,129,0,0,55,59,0,2022-01-27 18:30:00
4346.0,159,183,4350.25,4345.75,4349.0,13,/Date(1643326260000)/,253,296,0,0,94,113,0,2022-01-27 18:31:00
4346.0,130,139,4348.0,4346.0,4346.25,13,/Date(1643326320000)/,232,247,0,0,102,108,0,2022-01-27 18:32:00
4347.0,88,114,4347.25,4345.5,4346.0,13,/Date(1643326380000)/,213,269,0,0,125,155,0,2022-01-27 18:33:00
4346.25,64,85,4347.75,4345.75,4347.0,13,/Date(1643326440000)/,107,129,0,0,43,44,0,2022-01-27 18:34:00
4344.5,77,113,4346.5,4344.25,4346.25,13,/Date(1643326500000)/,122,159,0,0,45,46,0,2022-01-27 18:35:00
4346.25,41,44,4347.0,4344.5,4344.5,13,/Date(1643326560000)/,204,238,0,0,163,194,0,2022-01-27 18:36:00
4348.0,25,25,4348.0,4345.5,4346.5,13,/Date(1643326620000)/,111,120,0,0,86,95,0,2022-01-27 18:37:00
4347.0,115,149,4348.75,4347.0,4347.75,13,/Date(1643326680000)/,175,229,0,0,60,80,0,2022-01-27 18:38:00
4347.25,67,69,4348.75,4347.25,4347.25,13,/Date(1643326740000)/,116,122,0,0,49,53,0,2022-01-27 18:39:00
4347.75,47,52,4348.75,4347.5,4347.5,13,/Date(1643326800000)/,124,135,0,0,77,83,0,2022-01-27 18:40:00
4347.0,86,99,4348.25,4346.25,4347.75,13,/Date(1643326860000)/,171,191,0,0,85,92,0,2022-01-27 18:41:00
4343.0,202,264,4347.5,4342.75,4347.25,13,/Date(1643326920000)/,309,379,0,0,107,115,0,2022-01-27 18:42:00
4345.5,92,105,4345.5,4342.25,4342.75,13,/Date(1643326980000)/,278,321,0,0,186,216,0,2022-01-27 18:43:00
4343.25,120,145,4345.75,4342.75,4345.25,13,/Date(1643327040000)/,158,202,0,0,38,57,0,2022-01-27 18:44:00
4344.0,96,117,4344.0,4342.5,4343.0,13,/Date(1643327100000)/,165,199,0,0,69,82,0,2022-01-27 18:45:00
4344.75,60,68,4345.25,4343.25,4344.0,13,/Date(1643327160000)/,175,187,0,0,115,119,0,2022-01-27 18:46:00
4345.0,94,103,4347.5,4344.75,4344.75,13,/Date(1643327220000)/,185,197,0,0,91,94,0,2022-01-27 18:47:00
4344.75,85,101,4345.25,4343.0,4345.25,13,/Date(1643327280000)/,146,167,0,0,61,66,0,2022-01-27 18:48:00
4344.75,119,127,4345.75,4343.5,4344.75,13,/Date(1643327340000)/,207,223,0,0,88,96,0,2022-01-27 18:49:00
4343.25,83,95,4345.0,4342.75,4344.5,13,/Date(1643327400000)/,152,170,0,0,69,75,0,2022-01-27 18:50:00
4342.75,86,100,4343.5,4342.5,4343.0,13,/Date(1643327460000)/,163,203,0,0,77,103,0,2022-01-27 18:51:00
4341.25,199,216,4343.5,4340.0,4342.5,13,/Date(1643327520000)/,303,322,0,0,104,106,0,2022-01-27 18:52:00
4341.25,82,94,4341.5,4340.75,4341.25,13,/Date(1643327580000)/,135,155,0,0,53,61,0,2022-01-27 18:53:00
4341.5,81,90,4341.5,4340.5,4341.25,13,/Date(1643327640000)/,160,201,0,0,79,111,0,2022-01-27 18:54:00
4343.25,94,123,4344.0,4340.0,4341.5,13,/Date(1643327700000)/,187,241,0,0,93,118,0,2022-01-27 18:55:00
4340.75,142,173,4343.75,4340.25,4343.5,13,/Date(1643327760000)/,222,253,0,0,80,80,0,2022-01-27 18:56:00
4340.75,110,181,4340.75,4339.25,4340.5,13,/Date(1643327820000)/,228,321,0,0,118,140,0,2022-01-27 18:57:00
4337.75,303,530,4341.25,4337.25,4340.75,13,/Date(1643327880000)/,478,811,0,0,175,281,0,2022-01-27 18:58:00
4336.75,312,436,4338.0,4335.75,4337.75,13,/Date(1643327940000)/,591,830,0,0,279,394,0,2022-01-27 18:59:00
4335.5,198,249,4337.0,4335.25,4336.5,13,/Date(1643328000000)/,390,463,0,0,192,214,0,2022-01-27 19:00:00
4336.0,315,385,4336.75,4334.25,4335.5,13,/Date(1643328060000)/,592,708,0,0,277,323,0,2022-01-27 19:01:00
4331.75,270,349,4336.0,4331.5,4336.0,13,/Date(1643328120000)/,408,507,0,0,138,158,0,2022-01-27 19:02:00
4333.0,189,220,4333.5,4330.25,4332.0,13,/Date(1643328180000)/,477,563,0,0,288,343,0,2022-01-27 19:03:00
4333.75,128,146,4333.75,4331.0,4333.0,13,/Date(1643328240000)/,290,342,0,0,162,196,0,2022-01-27 19:04:00
4336.75,149,156,4337.75,4333.5,4333.75,13,/Date(1643328300000)/,419,468,0,0,270,312,0,2022-01-27 19:05:00
4336.5,91,94,4337.5,4336.0,4336.5,13,/Date(1643328360000)/,167,179,0,0,76,85,0,2022-01-27 19:06:00
4335.5,167,197,4336.75,4334.75,4336.5,13,/Date(1643328420000)/,280,358,0,0,113,161,0,2022-01-27 19:07:00
4337.75,26,26,4338.0,4335.5,4335.5,13,/Date(1643328480000)/,118,128,0,0,92,102,0,2022-01-27 19:08:00
4335.0,94,106,4337.5,4334.75,4337.5,13,/Date(1643328540000)/,151,176,0,0,57,70,0,2022-01-27 19:09:00
4331.0,161,192,4334.75,4330.75,4334.75,13,/Date(1643328600000)/,285,324,0,0,124,132,0,2022-01-27 19:10:00
4333.0,71,76,4333.5,4331.0,4331.0,13,/Date(1643328660000)/,198,233,0,0,127,157,0,2022-01-27 19:11:00
4335.25,64,67,4336.75,4333.0,4333.25,13,/Date(1643328720000)/,226,249,0,0,162,182,0,2022-01-27 19:12:00
4333.75,84,107,4335.5,4333.25,4335.5,13,/Date(1643328780000)/,132,162,0,0,48,55,0,2022-01-27 19:13:00
4336.0,41,45,4337.0,4334.0,4334.0,13,/Date(1643328840000)/,120,134,0,0,79,89,0,2022-01-27 19:14:00
4340.75,139,160,4341.0,4336.25,4336.25,13,/Date(1643328900000)/,515,621,0,0,376,461,0,2022-01-27 19:15:00
4338.75,208,256,4342.0,4337.75,4340.75,13,/Date(1643328960000)/,411,482,0,0,203,226,0,2022-01-27 19:16:00
4337.25,161,181,4338.5,4336.5,4338.5,13,/Date(1643329020000)/,257,292,0,0,96,111,0,2022-01-27 19:17:00
4337.5,70,73,4339.0,4336.5,4337.25,13,/Date(1643329080000)/,146,152,0,0,76,79,0,2022-01-27 19:18:00
4334.75,108,145,4337.75,4334.25,4337.5,13,/Date(1643329140000)/,204,246,0,0,96,101,0,2022-01-27 19:19:00
4335.5,60,75,4335.75,4333.75,4335.25,13,/Date(1643329200000)/,110,136,0,0,50,61,0,2022-01-27 19:20:00
4333.0,125,149,4336.5,4332.75,4336.0,13,/Date(1643329260000)/,227,272,0,0,102,123,0,2022-01-27 19:21:00
4333.25,64,78,4333.75,4332.0,4333.0,13,/Date(1643329320000)/,197,232,0,0,133,154,0,2022-01-27 19:22:00
4334.0,70,90,4334.25,4332.75,4333.25,13,/Date(1643329380000)/,151,188,0,0,81,98,0,2022-01-27 19:23:00
4334.75,60,61,4335.75,4333.25,4333.75,13,/Date(1643329440000)/,170,192,0,0,110,131,0,2022-01-27 19:24:00
4334.75,96,118,4336.0,4334.25,4334.5,13,/Date(1643329500000)/,232,271,0,0,136,153,0,2022-01-27 19:25:00
4336.5,94,106,4338.0,4333.5,4334.5,13,/Date(1643329560000)/,239,260,0,0,145,154,0,2022-01-27 19:26:00
4334.5,73,76,4336.5,4334.0,4336.25,13,/Date(1643329620000)/,156,173,0,0,83,97,0,2022-01-27 19:27:00
4334.5,107,139,4334.75,4332.75,4334.25,13,/Date(1643329680000)/,205,251,0,0,98,112,0,2022-01-27 19:28:00
4334.75,69,80,4335.25,4334.0,4334.25,13,/Date(1643329740000)/,139,195,0,0,70,115,0,2022-01-27 19:29:00
4332.25,125,141,4335.0,4332.0,4334.5,13,/Date(1643329800000)/,179,196,0,0,54,55,0,2022-01-27 19:30:00
4330.0,228,315,4333.75,4330.0,4332.25,13,/Date(1643329860000)/,411,526,0,0,183,211,0,2022-01-27 19:31:00
4323.75,1016,1432,4330.25,4322.75,4330.0,13,/Date(1643329920000)/,1634,2204,0,0,618,772,0,2022-01-27 19:32:00
4324.25,179,199,4325.5,4323.0,4324.0,13,/Date(1643329980000)/,384,448,0,0,205,249,0,2022-01-27 19:33:00
4325.0,166,183,4325.5,4322.5,4324.5,13,/Date(1643330040000)/,330,377,0,0,164,194,0,2022-01-27 19:34:00
4325.75,122,149,4327.25,4325.25,4325.25,13,/Date(1643330100000)/,293,359,0,0,171,210,0,2022-01-27 19:35:00
4327.25,135,156,4328.25,4325.5,4325.75,13,/Date(1643330160000)/,293,336,0,0,158,180,0,2022-01-27 19:36:00
4327.75,79,105,4328.75,4326.25,4327.0,13,/Date(1643330220000)/,168,203,0,0,89,98,0,2022-01-27 19:37:00
4329.0,92,97,4329.25,4326.75,4327.5,13,/Date(1643330280000)/,210,257,0,0,118,160,0,2022-01-27 19:38:00
4327.5,78,91,4329.25,4327.25,4329.0,13,/Date(1643330340000)/,131,151,0,0,53,60,0,2022-01-27 19:39:00
4327.25,91,94,4327.75,4326.5,4327.25,13,/Date(1643330400000)/,133,136,0,0,42,42,0,2022-01-27 19:40:00
4322.75,225,245,4327.0,4322.75,4327.0,13,/Date(1643330460000)/,311,335,0,0,86,90,0,2022-01-27 19:41:00
4323.0,150,174,4325.0,4322.25,4323.0,13,/Date(1643330520000)/,287,321,0,0,137,147,0,2022-01-27 19:42:00
4323.5,74,81,4324.25,4322.75,4323.5,13,/Date(1643330580000)/,140,160,0,0,66,79,0,2022-01-27 19:43:00
4323.5,83,86,4324.25,4322.75,4323.75,13,/Date(1643330640000)/,151,156,0,0,68,70,0,2022-01-27 19:44:00
4324.75,111,118,4326.0,4323.75,4323.75,13,/Date(1643330700000)/,245,273,0,0,134,155,0,2022-01-27 19:45:00
4326.0,62,73,4327.0,4324.5,4324.75,13,/Date(1643330760000)/,165,183,0,0,103,110,0,2022-01-27 19:46:00
4325.0,201,230,4325.75,4321.75,4325.75,13,/Date(1643330820000)/,292,336,0,0,91,106,0,2022-01-27 19:47:00
4328.0,77,84,4329.0,4325.25,4325.25,13,/Date(1643330880000)/,271,289,0,0,194,205,0,2022-01-27 19:48:00
4329.75,106,108,4330.5,4328.0,4328.0,13,/Date(1643330940000)/,295,320,0,0,189,212,0,2022-01-27 19:49:00
4329.5,109,122,4331.5,4329.0,4329.75,13,/Date(1643331000000)/,200,235,0,0,91,113,0,2022-01-27 19:50:00
4329.0,80,85,4330.5,4328.75,4329.75,13,/Date(1643331060000)/,145,154,0,0,65,69,0,2022-01-27 19:51:00
4329.5,79,83,4330.0,4328.5,4328.75,13,/Date(1643331120000)/,123,127,0,0,44,44,0,2022-01-27 19:52:00
4332.0,150,156,4334.75,4329.5,4330.0,13,/Date(1643331180000)/,369,401,0,0,219,245,0,2022-01-27 19:53:00
4334.5,213,257,4335.5,4331.75,4331.75,13,/Date(1643331240000)/,495,561,0,0,282,304,0,2022-01-27 19:54:00
4335.25,157,197,4336.25,4334.25,4334.25,13,/Date(1643331300000)/,324,390,0,0,167,193,0,2022-01-27 19:55:00
4338.25,234,308,4338.75,4335.0,4335.0,13,/Date(1643331360000)/,519,641,0,0,285,333,0,2022-01-27 19:56:00
4338.0,103,112,4339.0,4337.75,4338.25,13,/Date(1643331420000)/,198,215,0,0,95,103,0,2022-01-27 19:57:00
4340.25,122,131,4340.5,4338.0,4338.25,13,/Date(1643331480000)/,337,442,0,0,215,311,0,2022-01-27 19:58:00
4340.5,141,152,4340.5,4338.25,4340.0,13,/Date(1643331540000)/,276,304,0,0,135,152,0,2022-01-27 19:59:00
4339.25,321,371,4343.0,4338.5,4340.75,13,/Date(1643331600000)/,631,706,0,0,310,335,0,2022-01-27 20:00:00
4339.0,156,175,4340.5,4338.25,4339.0,13,/Date(1643331660000)/,276,308,0,0,120,133,0,2022-01-27 20:01:00
4341.75,107,110,4342.25,4338.75,4339.25,13,/Date(1643331720000)/,298,316,0,0,191,206,0,2022-01-27 20:02:00
4343.25,95,118,4343.25,4340.5,4341.75,13,/Date(1643331780000)/,208,237,0,0,113,119,0,2022-01-27 20:03:00
4345.75,252,284,4347.0,4343.25,4343.25,13,/Date(1643331840000)/,609,719,0,0,357,435,0,2022-01-27 20:04:00
4345.0,175,192,4346.75,4344.5,4345.75,13,/Date(1643331900000)/,408,467,0,0,233,275,0,2022-01-27 20:05:00
4346.25,89,110,4346.5,4343.25,4344.75,13,/Date(1643331960000)/,246,287,0,0,157,177,0,2022-01-27 20:06:00
4347.25,135,149,4348.0,4346.0,4346.25,13,/Date(1643332020000)/,298,336,0,0,163,187,0,2022-01-27 20:07:00
4346.0,129,141,4347.75,4345.0,4347.5,13,/Date(1643332080000)/,209,225,0,0,80,84,0,2022-01-27 20:08:00
4346.25,156,194,4347.5,4345.0,4345.75,13,/Date(1643332140000)/,366,480,0,0,210,286,0,2022-01-27 20:09:00
4340.0,392,440,4346.5,4339.5,4346.5,13,/Date(1643332200000)/,586,681,0,0,194,241,0,2022-01-27 20:10:00
4340.75,76,80,4342.0,4339.75,4339.75,13,/Date(1643332260000)/,235,297,0,0,159,217,0,2022-01-27 20:11:00
4340.5,127,146,4341.0,4339.25,4341.0,13,/Date(1643332320000)/,236,297,0,0,109,151,0,2022-01-27 20:12:00
4343.5,99,108,4343.75,4340.5,4340.5,13,/Date(1643332380000)/,263,311,0,0,164,203,0,2022-01-27 20:13:00
4340.75,125,127,4343.75,4340.0,4343.5,13,/Date(1643332440000)/,205,237,0,0,80,110,0,2022-01-27 20:14:00
4338.5,198,220,4341.0,4338.0,4340.75,13,/Date(1643332500000)/,301,363,0,0,103,143,0,2022-01-27 20:15:00
4339.0,112,137,4340.5,4338.25,4338.5,13,/Date(1643332560000)/,249,324,0,0,137,187,0,2022-01-27 20:16:00
4338.5,192,242,4339.0,4337.0,4338.75,13,/Date(1643332620000)/,317,369,0,0,125,127,0,2022-01-27 20:17:00
4337.75,61,69,4339.25,4337.5,4338.0,13,/Date(1643332680000)/,110,123,0,0,49,54,0,2022-01-27 20:18:00
4340.5,94,103,4340.75,4337.75,4338.25,13,/Date(1643332740000)/,238,259,0,0,144,156,0,2022-01-27 20:19:00
4342.5,90,93,4342.75,4340.25,4340.5,13,/Date(1643332800000)/,223,290,0,0,133,197,0,2022-01-27 20:20:00
4344.25,158,170,4345.25,4342.25,4342.5,13,/Date(1643332860000)/,306,357,0,0,148,187,0,2022-01-27 20:21:00
4345.0,98,110,4346.25,4343.5,4344.0,13,/Date(1643332920000)/,213,236,0,0,115,126,0,2022-01-27 20:22:00
4343.5,95,98,4345.25,4342.75,4345.25,13,/Date(1643332980000)/,193,226,0,0,98,128,0,2022-01-27 20:23:00
4342.25,66,70,4344.0,4342.0,4343.75,13,/Date(1643333040000)/,99,103,0,0,33,33,0,2022-01-27 20:24:00
4341.5,63,66,4343.25,4341.0,4342.0,13,/Date(1643333100000)/,98,103,0,0,35,37,0,2022-01-27 20:25:00
4344.25,44,45,4345.0,4341.25,4341.5,13,/Date(1643333160000)/,154,184,0,0,110,139,0,2022-01-27 20:26:00
4345.0,59,62,4346.25,4343.5,4344.0,13,/Date(1643333220000)/,174,197,0,0,115,135,0,2022-01-27 20:27:00
4346.5,27,31,4346.75,4345.0,4345.25,13,/Date(1643333280000)/,102,130,0,0,75,99,0,2022-01-27 20:28:00
4343.75,161,172,4346.75,4343.25,4346.75,13,/Date(1643333340000)/,246,267,0,0,85,95,0,2022-01-27 20:29:00
4345.25,124,130,4347.25,4344.0,4344.0,13,/Date(1643333400000)/,271,313,0,0,147,183,0,2022-01-27 20:30:00
4340.25,297,326,4346.25,4340.0,4345.5,13,/Date(1643333460000)/,470,525,0,0,173,199,0,2022-01-27 20:31:00
4341.5,58,66,4342.0,4339.75,4340.25,13,/Date(1643333520000)/,143,152,0,0,85,86,0,2022-01-27 20:32:00
4339.25,102,129,4342.25,4339.0,4341.75,13,/Date(1643333580000)/,161,189,0,0,59,60,0,2022-01-27 20:33:00
4339.0,167,197,4339.5,4337.5,4339.25,13,/Date(1643333640000)/,305,364,0,0,138,167,0,2022-01-27 20:34:00
4336.5,200,238,4338.75,4336.0,4338.75,13,/Date(1643333700000)/,375,418,0,0,175,180,0,2022-01-27 20:35:00
4338.0,92,94,4339.0,4336.75,4336.75,13,/Date(1643333760000)/,171,176,0,0,79,82,0,2022-01-27 20:36:00
4335.25,156,183,4338.0,4335.25,4338.0,13,/Date(1643333820000)/,233,263,0,0,77,80,0,2022-01-27 20:37:00
4337.75,141,145,4339.0,4335.0,4335.25,13,/Date(1643333880000)/,306,364,0,0,165,219,0,2022-01-27 20:38:00
4336.5,221,280,4339.5,4336.0,4337.75,13,/Date(1643333940000)/,346,410,0,0,125,130,0,2022-01-27 20:39:00
4336.25,62,71,4336.75,4335.25,4336.75,13,/Date(1643334000000)/,101,110,0,0,39,39,0,2022-01-27 20:40:00
4334.5,205,230,4336.75,4333.5,4336.0,13,/Date(1643334060000)/,286,314,0,0,81,84,0,2022-01-27 20:41:00
4334.5,61,66,4335.75,4334.0,4334.25,13,/Date(1643334120000)/,149,162,0,0,88,96,0,2022-01-27 20:42:00
4338.5,158,172,4339.0,4335.0,4335.0,13,/Date(1643334180000)/,360,399,0,0,202,227,0,2022-01-27 20:43:00
4340.0,118,123,4341.25,4338.5,4338.5,13,/Date(1643334240000)/,285,304,0,0,167,181,0,2022-01-27 20:44:00
4340.0,53,53,4340.5,4339.0,4340.0,13,/Date(1643334300000)/,127,132,0,0,74,79,0,2022-01-27 20:45:00
4340.75,124,134,4341.75,4339.25,4339.75,13,/Date(1643334360000)/,316,329,0,0,192,195,0,2022-01-27 20:46:00
4337.75,251,274,4342.75,4336.25,4340.75,13,/Date(1643334420000)/,451,479,0,0,200,205,0,2022-01-27 20:47:00
4335.0,204,239,4338.0,4334.0,4337.75,13,/Date(1643334480000)/,375,429,0,0,171,190,0,2022-01-27 20:48:00
4332.75,156,198,4335.5,4332.5,4335.25,13,/Date(1643334540000)/,267,320,0,0,111,122,0,2022-01-27 20:49:00
4333.25,97,102,4333.75,4332.0,4332.75,13,/Date(1643334600000)/,183,201,0,0,86,99,0,2022-01-27 20:50:00
4332.5,98,104,4336.25,4332.0,4333.25,13,/Date(1643334660000)/,227,261,0,0,129,157,0,2022-01-27 20:51:00
4333.25,99,114,4333.5,4331.0,4332.5,13,/Date(1643334720000)/,186,206,0,0,87,92,0,2022-01-27 20:52:00
4334.25,53,58,4334.25,4332.0,4332.75,13,/Date(1643334780000)/,128,137,0,0,75,79,0,2022-01-27 20:53:00
4332.75,64,71,4334.75,4332.0,4334.5,13,/Date(1643334840000)/,109,118,0,0,45,47,0,2022-01-27 20:54:00
4331.75,86,99,4333.0,4331.0,4333.0,13,/Date(1643334900000)/,143,160,0,0,57,61,0,2022-01-27 20:55:00
4334.75,80,83,4335.75,4332.0,4332.0,13,/Date(1643334960000)/,303,328,0,0,223,245,0,2022-01-27 20:56:00
4337.0,84,90,4337.5,4334.0,4334.75,13,/Date(1643335020000)/,247,257,0,0,163,167,0,2022-01-27 20:57:00
4338.0,123,137,4339.0,4336.5,4337.25,13,/Date(1643335080000)/,299,320,0,0,176,183,0,2022-01-27 20:58:00
4339.75,41,42,4340.0,4337.75,4337.75,13,/Date(1643335140000)/,128,140,0,0,87,98,0,2022-01-27 20:59:00
4339.0,59,70,4339.75,4338.25,4339.75,13,/Date(1643335200000)/,144,161,0,0,85,91,0,2022-01-27 21:00:00
4340.0,100,117,4342.25,4338.75,4339.25,13,/Date(1643335260000)/,238,261,0,0,138,144,0,2022-01-27 21:01:00
4337.25,170,190,4340.75,4337.25,4340.25,13,/Date(1643335320000)/,303,330,0,0,133,140,0,2022-01-27 21:02:00
4337.0,161,175,4337.75,4335.5,4337.5,13,/Date(1643335380000)/,251,273,0,0,90,98,0,2022-01-27 21:03:00
4337.25,47,47,4338.75,4336.0,4336.5,13,/Date(1643335440000)/,109,111,0,0,62,64,0,2022-01-27 21:04:00
4339.75,48,50,4339.75,4336.75,4337.25,13,/Date(1643335500000)/,117,124,0,0,69,74,0,2022-01-27 21:05:00
4339.0,73,77,4340.0,4338.25,4339.5,13,/Date(1643335560000)/,121,125,0,0,48,48,0,2022-01-27 21:06:00
4340.0,56,62,4340.5,4337.75,4339.0,13,/Date(1643335620000)/,144,160,0,0,88,98,0,2022-01-27 21:07:00
4339.75,64,66,4340.0,4338.75,4340.0,13,/Date(1643335680000)/,102,104,0,0,38,38,0,2022-01-27 21:08:00
4338.75,108,121,4340.0,4338.5,4340.0,13,/Date(1643335740000)/,182,203,0,0,74,82,0,2022-01-27 21:09:00
4339.25,92,99,4340.5,4338.0,4338.75,13,/Date(1643335800000)/,164,234,0,0,72,135,0,2022-01-27 21:10:00
4338.0,154,167,4340.5,4336.25,4339.75,13,/Date(1643335860000)/,267,283,0,0,113,116,0,2022-01-27 21:11:00
4339.25,48,52,4339.5,4338.0,4338.0,13,/Date(1643335920000)/,106,111,0,0,58,59,0,2022-01-27 21:12:00
4340.0,100,108,4342.0,4339.0,4339.0,13,/Date(1643335980000)/,247,297,0,0,147,189,0,2022-01-27 21:13:00
4340.0,80,85,4340.75,4338.75,4340.0,13,/Date(1643336040000)/,165,176,0,0,85,91,0,2022-01-27 21:14:00
4337.25,161,224,4339.5,4336.0,4339.5,13,/Date(1643336100000)/,222,288,0,0,61,64,0,2022-01-27 21:15:00
4336.75,54,59,4338.0,4336.25,4337.25,13,/Date(1643336160000)/,115,120,0,0,61,61,0,2022-01-27 21:16:00
4337.0,93,104,4337.75,4336.25,4336.75,13,/Date(1643336220000)/,191,219,0,0,98,115,0,2022-01-27 21:17:00
4337.25,65,73,4338.5,4336.5,4337.25,13,/Date(1643336280000)/,114,129,0,0,49,56,0,2022-01-27 21:18:00
4336.5,34,41,4337.25,4336.25,4337.25,13,/Date(1643336340000)/,64,74,0,0,30,33,0,2022-01-27 21:19:00
4334.5,141,172,4337.75,4334.25,4336.5,13,/Date(1643336400000)/,217,250,0,0,76,78,0,2022-01-27 21:20:00
4336.5,28,31,4336.5,4334.5,4334.5,13,/Date(1643336460000)/,104,110,0,0,76,79,0,2022-01-27 21:21:00
4337.0,32,35,4337.5,4336.5,4336.5,13,/Date(1643336520000)/,85,91,0,0,53,56,0,2022-01-27 21:22:00
4338.75,63,64,4338.75,4336.25,4336.75,13,/Date(1643336580000)/,142,150,0,0,79,86,0,2022-01-27 21:23:00
4341.0,248,309,4342.25,4339.0,4339.0,13,/Date(1643336640000)/,564,645,0,0,316,336,0,2022-01-27 21:24:00
4341.0,73,74,4342.0,4340.25,4341.25,13,/Date(1643336700000)/,131,138,0,0,58,64,0,2022-01-27 21:25:00
4341.0,120,133,4342.25,4340.5,4341.0,13,/Date(1643336760000)/,213,236,0,0,93,103,0,2022-01-27 21:26:00
4343.25,96,104,4343.25,4340.25,4341.0,13,/Date(1643336820000)/,201,228,0,0,105,124,0,2022-01-27 21:27:00
4344.75,116,127,4345.25,4342.75,4343.0,13,/Date(1643336880000)/,360,446,0,0,244,319,0,2022-01-27 21:28:00
4346.25,116,141,4347.25,4344.75,4345.0,13,/Date(1643336940000)/,306,338,0,0,190,197,0,2022-01-27 21:29:00
4345.25,85,94,4347.0,4345.25,4346.25,13,/Date(1643337000000)/,146,155,0,0,61,61,0,2022-01-27 21:30:00
4345.75,65,81,4346.5,4344.75,4345.25,13,/Date(1643337060000)/,147,168,0,0,82,87,0,2022-01-27 21:31:00
4346.0,60,66,4346.5,4345.75,4345.75,13,/Date(1643337120000)/,105,117,0,0,45,51,0,2022-01-27 21:32:00
4347.0,110,125,4347.0,4345.0,4346.0,13,/Date(1643337180000)/,246,274,0,0,136,149,0,2022-01-27 21:33:00
4346.5,109,122,4347.75,4345.75,4346.75,13,/Date(1643337240000)/,231,297,0,0,122,175,0,2022-01-27 21:34:00
4345.75,57,61,4346.25,4345.0,4346.25,13,/Date(1643337300000)/,93,97,0,0,36,36,0,2022-01-27 21:35:00
4345.0,130,145,4345.5,4344.0,4345.5,13,/Date(1643337360000)/,217,236,0,0,87,91,0,2022-01-27 21:36:00
4344.25,64,69,4345.5,4343.75,4345.25,13,/Date(1643337420000)/,115,123,0,0,51,54,0,2022-01-27 21:37:00
4344.5,47,51,4344.75,4344.0,4344.25,13,/Date(1643337480000)/,108,118,0,0,61,67,0,2022-01-27 21:38:00
4346.75,34,46,4347.0,4344.5,4344.5,13,/Date(1643337540000)/,148,165,0,0,114,119,0,2022-01-27 21:39:00
4347.75,139,246,4349.5,4346.5,4346.75,13,/Date(1643337600000)/,349,522,0,0,210,276,0,2022-01-27 21:40:00
4348.0,82,84,4348.5,4347.5,4347.5,13,/Date(1643337660000)/,148,160,0,0,66,76,0,2022-01-27 21:41:00
4346.5,92,99,4348.25,4346.0,4347.75,13,/Date(1643337720000)/,132,157,0,0,40,58,0,2022-01-27 21:42:00
4348.0,76,80,4348.75,4346.5,4346.5,13,/Date(1643337780000)/,174,200,0,0,98,120,0,2022-01-27 21:43:00
4347.5,43,45,4348.25,4347.25,4348.25,13,/Date(1643337840000)/,84,89,0,0,41,44,0,2022-01-27 21:44:00
4348.5,20,20,4348.5,4347.5,4347.5,13,/Date(1643337900000)/,49,51,0,0,29,31,0,2022-01-27 21:45:00
4348.75,71,78,4349.5,4347.75,4348.5,13,/Date(1643337960000)/,124,137,0,0,53,59,0,2022-01-27 21:46:00
4349.0,36,50,4349.25,4348.0,4348.75,13,/Date(1643338020000)/,60,75,0,0,24,25,0,2022-01-27 21:47:00
4349.5,54,58,4349.75,4348.75,4349.0,13,/Date(1643338080000)/,113,119,0,0,59,61,0,2022-01-27 21:48:00
4350.0,123,135,4350.5,4349.25,4349.75,13,/Date(1643338140000)/,278,404,0,0,155,269,0,2022-01-27 21:49:00
4353.0,140,150,4353.25,4350.0,4350.25,13,/Date(1643338200000)/,452,531,0,0,312,381,0,2022-01-27 21:50:00
4352.25,126,134,4353.75,4351.0,4353.0,13,/Date(1643338260000)/,269,286,0,0,143,152,0,2022-01-27 21:51:00
4352.0,69,74,4353.75,4352.0,4352.25,13,/Date(1643338320000)/,148,174,0,0,79,100,0,2022-01-27 21:52:00
4353.25,44,51,4353.25,4352.0,4352.0,13,/Date(1643338380000)/,107,129,0,0,63,78,0,2022-01-27 21:53:00
4353.0,40,41,4353.25,4352.0,4353.25,13,/Date(1643338440000)/,92,95,0,0,52,54,0,2022-01-27 21:54:00
4354.0,112,117,4354.5,4353.0,4353.0,13,/Date(1643338500000)/,307,436,0,0,195,319,0,2022-01-27 21:55:00
4355.5,136,167,4355.5,4354.0,4354.25,13,/Date(1643338560000)/,392,585,0,0,256,418,0,2022-01-27 21:56:00
4353.25,146,177,4355.5,4353.25,4355.5,13,/Date(1643338620000)/,235,278,0,0,89,101,0,2022-01-27 21:57:00
4353.75,62,66,4354.25,4353.25,4353.25,13,/Date(1643338680000)/,115,123,0,0,53,57,0,2022-01-27 21:58:00
4355.25,88,97,4355.5,4353.25,4353.75,13,/Date(1643338740000)/,163,213,0,0,75,116,0,2022-01-27 21:59:00
4354.25,145,173,4355.75,4354.0,4355.25,13,/Date(1643338800000)/,230,276,0,0,85,103,0,2022-01-27 22:00:00
4353.5,114,125,4355.25,4353.0,4354.5,13,/Date(1643338860000)/,227,243,0,0,113,118,0,2022-01-27 22:01:00
4354.0,57,81,4354.25,4353.25,4353.75,13,/Date(1643338920000)/,96,128,0,0,39,47,0,2022-01-27 22:02:00
4353.75,114,124,4355.25,4353.5,4354.0,13,/Date(1643338980000)/,172,186,0,0,58,62,0,2022-01-27 22:03:00
4353.75,37,39,4354.0,4353.5,4354.0,13,/Date(1643339040000)/,62,68,0,0,25,29,0,2022-01-27 22:04:00
4353.5,104,125,4354.0,4352.75,4353.5,13,/Date(1643339100000)/,172,214,0,0,68,89,0,2022-01-27 22:05:00
4352.0,99,116,4354.0,4351.75,4353.5,13,/Date(1643339160000)/,169,195,0,0,70,79,0,2022-01-27 22:06:00
4352.5,24,25,4353.0,4352.25,4352.25,13,/Date(1643339220000)/,81,95,0,0,57,70,0,2022-01-27 22:07:00
4351.0,178,199,4353.5,4350.75,4352.5,13,/Date(1643339280000)/,316,367,0,0,138,168,0,2022-01-27 22:08:00
4351.75,31,31,4352.25,4350.75,4351.25,13,/Date(1643339340000)/,133,147,0,0,102,116,0,2022-01-27 22:09:00
4353.75,58,59,4353.75,4351.75,4351.75,13,/Date(1643339400000)/,188,250,0,0,130,191,0,2022-01-27 22:10:00
4353.5,100,109,4354.0,4351.75,4353.75,13,/Date(1643339460000)/,185,195,0,0,85,86,0,2022-01-27 22:11:00
4356.0,87,122,4356.0,4353.25,4353.5,13,/Date(1643339520000)/,292,436,0,0,205,314,0,2022-01-27 22:12:00
4355.75,102,109,4356.25,4355.25,4356.0,13,/Date(1643339580000)/,190,203,0,0,88,94,0,2022-01-27 22:13:00
4354.0,83,94,4356.0,4353.75,4355.5,13,/Date(1643339640000)/,119,145,0,0,36,51,0,2022-01-27 22:14:00
4353.25,51,56,4354.25,4352.5,4354.0,13,/Date(1643339700000)/,118,123,0,0,67,67,0,2022-01-27 22:15:00
4349.25,242,287,4353.5,4349.25,4353.5,13,/Date(1643339760000)/,360,422,0,0,118,135,0,2022-01-27 22:16:00
4349.75,72,81,4351.0,4349.25,4349.5,13,/Date(1643339820000)/,170,183,0,0,98,102,0,2022-01-27 22:17:00
4348.25,111,122,4350.0,4347.75,4350.0,13,/Date(1643339880000)/,182,195,0,0,71,73,0,2022-01-27 22:18:00
4347.5,211,233,4348.5,4346.0,4348.25,13,/Date(1643339940000)/,332,364,0,0,121,131,0,2022-01-27 22:19:00
4347.5,77,85,4348.25,4347.25,4347.5,13,/Date(1643340000000)/,145,155,0,0,68,70,0,2022-01-27 22:20:00
4349.0,81,86,4349.5,4347.5,4347.5,13,/Date(1643340060000)/,183,194,0,0,102,108,0,2022-01-27 22:21:00
4348.5,79,85,4349.5,4348.25,4349.25,13,/Date(1643340120000)/,109,118,0,0,30,33,0,2022-01-27 22:22:00
4347.0,100,102,4348.75,4346.75,4348.5,13,/Date(1643340180000)/,131,133,0,0,31,31,0,2022-01-27 22:23:00
4346.75,235,258,4346.75,4344.5,4346.75,13,/Date(1643340240000)/,354,381,0,0,119,123,0,2022-01-27 22:24:00
4346.5,47,48,4348.0,4346.5,4347.0,13,/Date(1643340300000)/,107,112,0,0,60,64,0,2022-01-27 22:25:00
4345.75,73,79,4347.0,4345.5,4346.5,13,/Date(1643340360000)/,93,99,0,0,20,20,0,2022-01-27 22:26:00
4346.0,88,98,4346.25,4344.75,4345.5,13,/Date(1643340420000)/,168,188,0,0,80,90,0,2022-01-27 22:27:00
4344.75,97,103,4346.0,4343.75,4346.0,13,/Date(1643340480000)/,179,189,0,0,82,86,0,2022-01-27 22:28:00
4345.5,46,48,4346.0,4344.25,4344.5,13,/Date(1643340540000)/,99,104,0,0,53,56,0,2022-01-27 22:29:00
4344.25,99,134,4346.25,4344.0,4345.5,13,/Date(1643340600000)/,163,199,0,0,64,65,0,2022-01-27 22:30:00
4344.25,76,79,4345.5,4343.75,4344.25,13,/Date(1643340660000)/,152,184,0,0,76,105,0,2022-01-27 22:31:00
4345.0,41,43,4346.25,4344.25,4344.5,13,/Date(1643340720000)/,95,97,0,0,54,54,0,2022-01-27 22:32:00
4346.25,30,30,4346.5,4344.75,4345.0,13,/Date(1643340780000)/,123,132,0,0,93,102,0,2022-01-27 22:33:00
4346.0,86,90,4347.0,4345.0,4346.0,13,/Date(1643340840000)/,154,165,0,0,68,75,0,2022-01-27 22:34:00
4346.25,49,56,4347.0,4345.0,4345.75,13,/Date(1643340900000)/,120,137,0,0,71,81,0,2022-01-27 22:35:00
4346.25,53,58,4346.75,4345.75,4346.25,13,/Date(1643340960000)/,105,116,0,0,52,58,0,2022-01-27 22:36:00
4345.25,62,66,4347.5,4345.25,4346.5,13,/Date(1643341020000)/,126,159,0,0,64,93,0,2022-01-27 22:37:00
4344.0,134,161,4345.75,4343.25,4345.5,13,/Date(1643341080000)/,213,244,0,0,79,83,0,2022-01-27 22:38:00
4345.75,43,51,4345.75,4344.25,4344.25,13,/Date(1643341140000)/,116,125,0,0,73,74,0,2022-01-27 22:39:00
4346.25,37,37,4346.5,4345.25,4345.75,13,/Date(1643341200000)/,114,125,0,0,77,88,0,2022-01-27 22:40:00
4345.25,87,116,4346.5,4344.5,4346.5,13,/Date(1643341260000)/,155,195,0,0,68,79,0,2022-01-27 22:41:00
4344.75,62,63,4345.5,4344.5,4345.25,13,/Date(1643341320000)/,85,88,0,0,23,25,0,2022-01-27 22:42:00
4342.0,193,251,4345.0,4341.75,4344.75,13,/Date(1643341380000)/,289,350,0,0,96,99,0,2022-01-27 22:43:00
4342.75,59,65,4343.25,4341.75,4341.75,13,/Date(1643341440000)/,124,130,0,0,65,65,0,2022-01-27 22:44:00
4342.5,102,149,4343.25,4341.5,4342.75,13,/Date(1643341500000)/,183,241,0,0,81,92,0,2022-01-27 22:45:00
4341.75,79,113,4342.75,4341.75,4342.25,13,/Date(1643341560000)/,150,200,0,0,71,87,0,2022-01-27 22:46:00
4342.5,68,76,4342.5,4340.75,4341.75,13,/Date(1643341620000)/,136,151,0,0,68,75,0,2022-01-27 22:47:00
4344.75,54,59,4345.0,4341.5,4342.25,13,/Date(1643341680000)/,176,197,0,0,122,138,0,2022-01-27 22:48:00
4345.0,54,56,4345.75,4344.0,4344.75,13,/Date(1643341740000)/,100,102,0,0,46,46,0,2022-01-27 22:49:00
4343.5,82,84,4345.25,4342.0,4344.75,13,/Date(1643341800000)/,126,131,0,0,44,47,0,2022-01-27 22:50:00
4344.5,21,25,4345.0,4343.5,4343.5,13,/Date(1643341860000)/,69,75,0,0,48,50,0,2022-01-27 22:51:00
4343.25,61,69,4344.5,4343.0,4344.5,13,/Date(1643341920000)/,106,116,0,0,45,47,0,2022-01-27 22:52:00
4342.75,45,47,4344.25,4342.75,4343.0,13,/Date(1643341980000)/,83,91,0,0,38,44,0,2022-01-27 22:53:00
4342.0,83,88,4342.75,4341.5,4342.75,13,/Date(1643342040000)/,112,118,0,0,29,30,0,2022-01-27 22:54:00
4341.5,167,235,4342.0,4339.25,4342.0,13,/Date(1643342100000)/,321,397,0,0,154,162,0,2022-01-27 22:55:00
4340.5,36,37,4341.5,4340.0,4341.25,13,/Date(1643342160000)/,100,108,0,0,64,71,0,2022-01-27 22:56:00
4342.0,40,44,4342.5,4340.5,4340.5,13,/Date(1643342220000)/,137,142,0,0,97,98,0,2022-01-27 22:57:00
4341.0,86,90,4341.75,4339.5,4341.75,13,/Date(1643342280000)/,156,182,0,0,70,92,0,2022-01-27 22:58:00
4339.75,59,63,4341.25,4339.25,4341.25,13,/Date(1643342340000)/,117,123,0,0,58,60,0,2022-01-27 22:59:00
4340.25,59,60,4340.75,4339.5,4339.75,13,/Date(1643342400000)/,112,118,0,0,53,58,0,2022-01-27 23:00:00
4340.75,86,87,4342.0,4340.5,4340.5,13,/Date(1643342460000)/,176,181,0,0,90,94,0,2022-01-27 23:01:00
4339.75,146,153,4342.75,4339.75,4341.0,13,/Date(1643342520000)/,240,251,0,0,94,98,0,2022-01-27 23:02:00
4341.75,80,86,4344.25,4339.75,4339.75,13,/Date(1643342580000)/,191,202,0,0,111,116,0,2022-01-27 23:03:00
4341.75,29,29,4342.75,4341.75,4342.25,13,/Date(1643342640000)/,56,57,0,0,27,28,0,2022-01-27 23:04:00
4340.75,99,102,4341.75,4340.25,4341.75,13,/Date(1643342700000)/,180,188,0,0,81,86,0,2022-01-27 23:05:00
4341.5,10,10,4341.75,4341.0,4341.0,13,/Date(1643342760000)/,32,32,0,0,22,22,0,2022-01-27 23:06:00
4339.75,129,137,4341.75,4338.75,4341.0,13,/Date(1643342820000)/,217,227,0,0,88,90,0,2022-01-27 23:07:00
4340.5,49,50,4341.0,4339.25,4340.0,13,/Date(1643342880000)/,111,114,0,0,62,64,0,2022-01-27 23:08:00
4341.25,65,81,4342.25,4340.75,4340.75,13,/Date(1643342940000)/,142,160,0,0,77,79,0,2022-01-27 23:09:00
4340.25,53,69,4341.5,4340.25,4341.5,13,/Date(1643343000000)/,112,131,0,0,59,62,0,2022-01-27 23:10:00
4340.5,54,65,4341.25,4339.25,4340.25,13,/Date(1643343060000)/,151,169,0,0,97,104,0,2022-01-27 23:11:00
4340.0,85,115,4341.25,4339.25,4340.75,13,/Date(1643343120000)/,140,176,0,0,55,61,0,2022-01-27 23:12:00
4341.25,41,58,4341.5,4340.25,4340.25,13,/Date(1643343180000)/,108,129,0,0,67,71,0,2022-01-27 23:13:00
4341.25,17,25,4341.25,4340.5,4341.25,13,/Date(1643343240000)/,57,73,0,0,40,48,0,2022-01-27 23:14:00
4340.75,81,91,4341.25,4339.75,4341.25,13,/Date(1643343300000)/,122,134,0,0,41,43,0,2022-01-27 23:15:00
4340.75,21,23,4340.75,4340.25,4340.75,13,/Date(1643343360000)/,34,42,0,0,13,19,0,2022-01-27 23:16:00
4338.75,102,109,4341.0,4338.75,4340.75,13,/Date(1643343420000)/,143,151,0,0,41,42,0,2022-01-27 23:17:00
4339.25,47,51,4340.0,4338.75,4339.0,13,/Date(1643343480000)/,106,120,0,0,59,69,0,2022-01-27 23:18:00
4338.0,116,135,4339.5,4337.0,4339.0,13,/Date(1643343540000)/,191,222,0,0,75,87,0,2022-01-27 23:19:00
4337.25,132,154,4338.0,4335.75,4337.75,13,/Date(1643343600000)/,226,272,0,0,94,118,0,2022-01-27 23:20:00
4337.0,87,95,4338.25,4337.0,4337.0,13,/Date(1643343660000)/,137,146,0,0,50,51,0,2022-01-27 23:21:00
4338.0,61,63,4338.5,4337.0,4337.25,13,/Date(1643343720000)/,139,144,0,0,78,81,0,2022-01-27 23:22:00
4337.25,36,39,4338.25,4336.5,4338.0,13,/Date(1643343780000)/,76,79,0,0,40,40,0,2022-01-27 23:23:00
4337.5,33,37,4337.75,4336.0,4337.25,13,/Date(1643343840000)/,70,76,0,0,37,39,0,2022-01-27 23:24:00
4336.75,113,142,4337.25,4335.25,4337.0,13,/Date(1643343900000)/,181,214,0,0,68,72,0,2022-01-27 23:25:00
4336.75,36,37,4337.5,4336.0,4337.5,13,/Date(1643343960000)/,83,85,0,0,47,48,0,2022-01-27 23:26:00
4336.0,66,69,4337.25,4336.0,4336.75,13,/Date(1643344020000)/,104,128,0,0,38,59,0,2022-01-27 23:27:00
4338.5,57,98,4338.5,4335.75,4336.0,13,/Date(1643344080000)/,110,159,0,0,53,61,0,2022-01-27 23:28:00
4339.75,24,28,4340.0,4338.0,4338.25,13,/Date(1643344140000)/,91,98,0,0,67,70,0,2022-01-27 23:29:00
4338.5,105,117,4339.5,4337.75,4339.5,13,/Date(1643344200000)/,153,169,0,0,48,52,0,2022-01-27 23:30:00
4337.75,71,114,4339.0,4337.25,4338.75,13,/Date(1643344260000)/,98,143,0,0,27,29,0,2022-01-27 23:31:00
4339.25,48,51,4340.0,4337.75,4338.0,13,/Date(1643344320000)/,182,210,0,0,134,159,0,2022-01-27 23:32:00
4339.75,59,65,4340.5,4338.0,4339.25,13,/Date(1643344380000)/,115,125,0,0,56,60,0,2022-01-27 23:33:00
4340.25,87,126,4341.5,4339.75,4340.0,13,/Date(1643344440000)/,207,265,0,0,120,139,0,2022-01-27 23:34:00
4340.5,68,93,4341.0,4339.5,4340.5,13,/Date(1643344500000)/,128,155,0,0,60,62,0,2022-01-27 23:35:00
4340.0,33,33,4340.5,4339.75,4340.5,13,/Date(1643344560000)/,56,56,0,0,23,23,0,2022-01-27 23:36:00
4339.5,56,65,4340.0,4339.0,4340.0,13,/Date(1643344620000)/,99,109,0,0,43,44,0,2022-01-27 23:37:00
4340.0,39,43,4340.0,4338.75,4339.25,13,/Date(1643344680000)/,87,94,0,0,48,51,0,2022-01-27 23:38:00
4339.75,40,41,4341.25,4339.75,4339.75,13,/Date(1643344740000)/,69,72,0,0,29,31,0,2022-01-27 23:39:00
4339.0,68,78,4339.75,4338.75,4339.75,13,/Date(1643344800000)/,124,140,0,0,56,62,0,2022-01-27 23:40:00
4340.25,14,14,4340.75,4339.5,4339.5,13,/Date(1643344860000)/,58,60,0,0,44,46,0,2022-01-27 23:41:00
4340.25,43,47,4340.25,4339.25,4340.25,13,/Date(1643344920000)/,82,88,0,0,39,41,0,2022-01-27 23:42:00
4340.0,67,92,4341.25,4339.75,4340.5,13,/Date(1643344980000)/,107,166,0,0,40,74,0,2022-01-27 23:43:00
4338.75,116,153,4340.25,4338.5,4340.0,13,/Date(1643345040000)/,158,219,0,0,42,66,0,2022-01-27 23:44:00
4339.0,80,119,4339.75,4338.5,4339.0,13,/Date(1643345100000)/,165,222,0,0,85,103,0,2022-01-27 23:45:00
4340.0,102,122,4340.5,4337.25,4338.75,13,/Date(1643345160000)/,266,330,0,0,164,208,0,2022-01-27 23:46:00
4340.25,33,53,4340.75,4339.5,4340.25,13,/Date(1643345220000)/,83,108,0,0,50,55,0,2022-01-27 23:47:00
4340.0,147,167,4340.25,4337.5,4340.25,13,/Date(1643345280000)/,270,296,0,0,123,129,0,2022-01-27 23:48:00
4339.25,36,39,4340.25,4339.25,4340.0,13,/Date(1643345340000)/,69,73,0,0,33,34,0,2022-01-27 23:49:00
4335.75,211,224,4339.5,4335.5,4339.25,13,/Date(1643345400000)/,292,307,0,0,81,83,0,2022-01-27 23:50:00
4335.0,246,293,4336.0,4333.75,4335.75,13,/Date(1643345460000)/,421,487,0,0,175,194,0,2022-01-27 23:51:00
4334.75,203,220,4335.75,4333.25,4335.0,13,/Date(1643345520000)/,406,433,0,0,203,213,0,2022-01-27 23:52:00
4335.25,63,63,4335.5,4334.0,4334.5,13,/Date(1643345580000)/,136,165,0,0,73,102,0,2022-01-27 23:53:00
4334.0,137,143,4335.5,4333.75,4335.5,13,/Date(1643345640000)/,217,231,0,0,80,88,0,2022-01-27 23:54:00
4333.5,178,219,4334.25,4332.75,4334.0,13,/Date(1643345700000)/,352,404,0,0,174,185,0,2022-01-27 23:55:00
4332.0,284,347,4333.5,4331.75,4333.5,13,/Date(1643345760000)/,513,586,0,0,229,239,0,2022-01-27 23:56:00
4333.25,44,47,4334.0,4331.75,4332.25,13,/Date(1643345820000)/,157,170,0,0,113,123,0,2022-01-27 23:57:00
4333.25,171,187,4333.75,4331.75,4333.5,13,/Date(1643345880000)/,316,336,0,0,145,149,0,2022-01-27 23:58:00
4332.5,194,203,4334.25,4331.75,4333.5,13,/Date(1643345940000)/,293,305,0,0,99,102,0,2022-01-27 23:59:00
4333.25,48,52,4333.5,4332.25,4332.25,13,/Date(1643346000000)/,94,111,0,0,46,59,0,2022-01-28 00:00:00
4332.5,225,241,4333.5,4330.75,4333.0,13,/Date(1643346060000)/,403,435,0,0,178,194,0,2022-01-28 00:01:00
4332.0,112,132,4332.5,4331.5,4332.25,13,/Date(1643346120000)/,176,203,0,0,64,71,0,2022-01-28 00:02:00
4332.25,52,58,4332.5,4331.0,4331.75,13,/Date(1643346180000)/,121,134,0,0,69,76,0,2022-01-28 00:03:00
4332.25,46,53,4332.5,4331.5,4332.25,13,/Date(1643346240000)/,111,125,0,0,65,72,0,2022-01-28 00:04:00
4333.75,84,92,4334.0,4331.75,4332.25,13,/Date(1643346300000)/,264,313,0,0,180,221,0,2022-01-28 00:05:00
4335.0,126,134,4335.5,4332.25,4333.5,13,/Date(1643346360000)/,291,332,0,0,165,198,0,2022-01-28 00:06:00
4333.25,110,110,4335.25,4333.25,4335.0,13,/Date(1643346420000)/,194,202,0,0,84,92,0,2022-01-28 00:07:00
4334.0,92,102,4335.0,4332.75,4333.5,13,/Date(1643346480000)/,249,270,0,0,157,168,0,2022-01-28 00:08:00
4333.75,117,125,4334.5,4332.25,4334.0,13,/Date(1643346540000)/,205,217,0,0,88,92,0,2022-01-28 00:09:00
4331.75,199,219,4334.75,4331.75,4333.75,13,/Date(1643346600000)/,374,407,0,0,175,188,0,2022-01-28 00:10:00
4332.5,326,374,4333.25,4330.0,4331.5,13,/Date(1643346660000)/,650,724,0,0,324,350,0,2022-01-28 00:11:00
4335.25,263,271,4335.5,4331.0,4332.75,13,/Date(1643346720000)/,572,607,0,0,309,336,0,2022-01-28 00:12:00
4340.0,444,543,4341.25,4334.5,4335.0,13,/Date(1643346780000)/,1121,1373,0,0,677,830,0,2022-01-28 00:13:00
4341.25,177,217,4341.25,4339.5,4340.25,13,/Date(1643346840000)/,462,556,0,0,285,339,0,2022-01-28 00:14:00
4340.25,223,258,4342.0,4340.0,4341.25,13,/Date(1643346900000)/,441,499,0,0,218,241,0,2022-01-28 00:15:00
4344.0,219,245,4344.75,4340.0,4340.0,13,/Date(1643346960000)/,544,635,0,0,325,390,0,2022-01-28 00:16:00
4343.5,108,117,4344.25,4343.25,4344.0,13,/Date(1643347020000)/,194,231,0,0,86,114,0,2022-01-28 00:17:00
4343.5,224,232,4345.0,4343.25,4343.5,13,/Date(1643347080000)/,448,519,0,0,224,287,0,2022-01-28 00:18:00
4344.75,166,173,4346.5,4343.5,4343.5,13,/Date(1643347140000)/,387,408,0,0,221,235,0,2022-01-28 00:19:00
4346.0,330,378,4347.25,4343.25,4344.75,13,/Date(1643347200000)/,700,787,0,0,370,409,0,2022-01-28 00:20:00
4346.0,207,233,4347.5,4345.25,4345.75,13,/Date(1643347260000)/,427,470,0,0,220,237,0,2022-01-28 00:21:00
4347.0,128,143,4347.75,4346.0,4346.0,13,/Date(1643347320000)/,305,368,0,0,177,225,0,2022-01-28 00:22:00
4348.5,167,177,4349.0,4347.0,4347.25,13,/Date(1643347380000)/,366,392,0,0,199,215,0,2022-01-28 00:23:00
4347.75,116,122,4348.5,4347.0,4348.5,13,/Date(1643347440000)/,221,239,0,0,105,117,0,2022-01-28 00:24:00
4347.0,105,108,4348.0,4346.25,4348.0,13,/Date(1643347500000)/,193,201,0,0,88,93,0,2022-01-28 00:25:00
4347.5,150,157,4348.75,4346.5,4347.0,13,/Date(1643347560000)/,354,375,0,0,204,218,0,2022-01-28 00:26:00
4349.75,87,92,4349.75,4347.25,4347.5,13,/Date(1643347620000)/,297,326,0,0,210,234,0,2022-01-28 00:27:00
4348.25,73,76,4350.0,4347.25,4349.75,13,/Date(1643347680000)/,178,196,0,0,105,120,0,2022-01-28 00:28:00
4348.0,114,121,4349.5,4347.5,4348.25,13,/Date(1643347740000)/,258,281,0,0,144,160,0,2022-01-28 00:29:00
4348.5,74,76,4349.25,4347.0,4348.25,13,/Date(1643347800000)/,206,222,0,0,132,146,0,2022-01-28 00:30:00
4348.25,54,56,4348.75,4347.5,4348.5,13,/Date(1643347860000)/,106,111,0,0,52,55,0,2022-01-28 00:31:00
4348.75,137,153,4349.75,4347.75,4348.25,13,/Date(1643347920000)/,258,309,0,0,121,156,0,2022-01-28 00:32:00
4348.75,31,33,4349.0,4347.25,4349.0,13,/Date(1643347980000)/,75,77,0,0,44,44,0,2022-01-28 00:33:00
4347.75,101,113,4349.25,4347.5,4348.75,13,/Date(1643348040000)/,169,188,0,0,68,75,0,2022-01-28 00:34:00
4344.5,259,277,4348.0,4344.5,4348.0,13,/Date(1643348100000)/,347,370,0,0,88,93,0,2022-01-28 00:35:00
4342.0,300,344,4345.25,4342.0,4344.5,13,/Date(1643348160000)/,436,497,0,0,136,153,0,2022-01-28 00:36:00
4343.5,189,193,4343.75,4340.5,4341.75,13,/Date(1643348220000)/,401,411,0,0,212,218,0,2022-01-28 00:37:00
4343.25,135,142,4345.0,4343.0,4343.5,13,/Date(1643348280000)/,290,310,0,0,155,168,0,2022-01-28 00:38:00
4343.5,43,46,4344.0,4343.0,4343.25,13,/Date(1643348340000)/,90,93,0,0,47,47,0,2022-01-28 00:39:00
4344.0,54,55,4344.25,4342.75,4343.5,13,/Date(1643348400000)/,119,127,0,0,65,72,0,2022-01-28 00:40:00
4345.0,72,82,4345.75,4344.0,4344.25,13,/Date(1643348460000)/,211,250,0,0,139,168,0,2022-01-28 00:41:00
4345.5,38,40,4346.25,4345.0,4345.0,13,/Date(1643348520000)/,108,110,0,0,70,70,0,2022-01-28 00:42:00
4345.25,81,130,4345.5,4344.25,4345.5,13,/Date(1643348580000)/,196,251,0,0,115,121,0,2022-01-28 00:43:00
4344.25,58,61,4345.25,4343.75,4345.25,13,/Date(1643348640000)/,97,103,0,0,39,42,0,2022-01-28 00:44:00
4345.5,36,36,4345.75,4344.25,4344.25,13,/Date(1643348700000)/,129,142,0,0,93,106,0,2022-01-28 00:45:00
4343.75,114,169,4345.5,4342.25,4345.5,13,/Date(1643348760000)/,182,238,0,0,68,69,0,2022-01-28 00:46:00
4344.25,30,31,4344.75,4343.25,4343.75,13,/Date(1643348820000)/,57,59,0,0,27,28,0,2022-01-28 00:47:00
4344.0,45,47,4344.75,4343.75,4344.25,13,/Date(1643348880000)/,79,82,0,0,34,35,0,2022-01-28 00:48:00
4344.75,21,21,4344.75,4343.5,4344.0,13,/Date(1643348940000)/,93,95,0,0,72,74,0,2022-01-28 00:49:00
4344.0,29,33,4344.75,4344.0,4344.75,13,/Date(1643349000000)/,46,51,0,0,17,18,0,2022-01-28 00:50:00
4344.5,41,43,4344.5,4342.75,4344.0,13,/Date(1643349060000)/,83,94,0,0,42,51,0,2022-01-28 00:51:00
4344.75,39,39,4345.5,4343.75,4344.25,13,/Date(1643349120000)/,90,96,0,0,51,57,0,2022-01-28 00:52:00
4346.0,82,87,4346.75,4344.5,4345.0,13,/Date(1643349180000)/,191,210,0,0,109,123,0,2022-01-28 00:53:00
4345.0,62,66,4346.5,4344.5,4346.0,13,/Date(1643349240000)/,100,105,0,0,38,39,0,2022-01-28 00:54:00
4346.5,7,7,4346.5,4345.25,4345.25,13,/Date(1643349300000)/,36,36,0,0,29,29,0,2022-01-28 00:55:00
4347.5,76,84,4347.75,4346.0,4346.5,13,/Date(1643349360000)/,193,215,0,0,117,131,0,2022-01-28 00:56:00
4347.0,98,101,4348.5,4345.25,4347.25,13,/Date(1643349420000)/,261,319,0,0,163,218,0,2022-01-28 00:57:00
4345.25,56,60,4347.0,4345.0,4346.75,13,/Date(1643349480000)/,95,101,0,0,39,41,0,2022-01-28 00:58:00
4344.75,22,27,4345.75,4344.75,4344.75,13,/Date(1643349540000)/,54,60,0,0,32,33,0,2022-01-28 00:59:00
4346.75,33,38,4347.25,4344.25,4344.5,13,/Date(1643349600000)/,101,114,0,0,68,76,0,2022-01-28 01:00:00
4345.5,204,224,4347.0,4342.5,4346.5,13,/Date(1643349660000)/,400,429,0,0,196,205,0,2022-01-28 01:01:00
4348.5,137,181,4348.5,4345.5,4345.5,13,/Date(1643349720000)/,358,467,0,0,221,286,0,2022-01-28 01:02:00
4349.5,184,232,4351.25,4348.0,4348.5,13,/Date(1643349780000)/,496,659,0,0,312,427,0,2022-01-28 01:03:00
4347.25,251,367,4349.25,4346.0,4349.25,13,/Date(1643349840000)/,402,534,0,0,151,167,0,2022-01-28 01:04:00
4346.25,79,90,4347.25,4346.0,4347.0,13,/Date(1643349900000)/,113,128,0,0,34,38,0,2022-01-28 01:05:00
4344.25,108,125,4346.5,4344.25,4346.25,13,/Date(1643349960000)/,151,170,0,0,43,45,0,2022-01-28 01:06:00
4343.75,49,56,4345.75,4343.75,4344.5,13,/Date(1643350020000)/,78,90,0,0,29,34,0,2022-01-28 01:07:00
4344.75,49,52,4346.25,4343.5,4344.0,13,/Date(1643350080000)/,116,133,0,0,67,81,0,2022-01-28 01:08:00
4345.5,33,36,4345.75,4344.0,4344.75,13,/Date(1643350140000)/,93,112,0,0,60,76,0,2022-01-28 01:09:00
4343.75,93,105,4345.5,4343.75,4345.5,13,/Date(1643350200000)/,132,144,0,0,39,39,0,2022-01-28 01:10:00
4341.75,294,354,4343.5,4340.75,4343.5,13,/Date(1643350260000)/,474,600,0,0,180,246,0,2022-01-28 01:11:00
4340.5,219,262,4341.75,4339.25,4341.75,13,/Date(1643350320000)/,331,400,0,0,112,138,0,2022-01-28 01:12:00
4341.5,51,51,4342.25,4340.5,4340.5,13,/Date(1643350380000)/,146,159,0,0,95,108,0,2022-01-28 01:13:00
4342.0,26,29,4342.5,4341.5,4341.75,13,/Date(1643350440000)/,62,67,0,0,36,38,0,2022-01-28 01:14:00
4343.5,53,58,4343.5,4342.0,4342.25,13,/Date(1643350500000)/,150,161,0,0,97,103,0,2022-01-28 01:15:00
4345.25,55,56,4345.75,4342.75,4343.25,13,/Date(1643350560000)/,176,187,0,0,121,131,0,2022-01-28 01:16:00
4346.0,44,47,4346.25,4345.25,4345.5,13,/Date(1643350620000)/,107,118,0,0,63,71,0,2022-01-28 01:17:00
4345.25,58,78,4345.75,4344.25,4345.75,13,/Date(1643350680000)/,111,140,0,0,53,62,0,2022-01-28 01:18:00
4343.75,109,110,4345.25,4343.25,4345.25,13,/Date(1643350740000)/,172,181,0,0,63,71,0,2022-01-28 01:19:00
4344.25,55,59,4345.0,4343.5,4343.75,13,/Date(1643350800000)/,98,117,0,0,43,58,0,2022-01-28 01:20:00
4345.75,40,43,4346.25,4344.5,4344.5,13,/Date(1643350860000)/,108,133,0,0,68,90,0,2022-01-28 01:21:00
4345.5,29,30,4346.0,4345.0,4345.25,13,/Date(1643350920000)/,53,56,0,0,24,26,0,2022-01-28 01:22:00
4345.75,59,59,4346.25,4344.75,4345.5,13,/Date(1643350980000)/,121,129,0,0,62,70,0,2022-01-28 01:23:00
4346.25,51,58,4346.5,4345.5,4346.0,13,/Date(1643351040000)/,125,151,0,0,74,93,0,2022-01-28 01:24:00
4346.5,16,20,4346.5,4345.75,4346.0,13,/Date(1643351100000)/,51,63,0,0,35,43,0,2022-01-28 01:25:00
4346.75,45,54,4346.75,4346.25,4346.5,13,/Date(1643351160000)/,125,153,0,0,80,99,0,2022-01-28 01:26:00
4346.25,49,55,4346.5,4345.25,4346.5,13,/Date(1643351220000)/,103,121,0,0,54,66,0,2022-01-28 01:27:00
4346.25,43,51,4346.75,4345.5,4346.0,13,/Date(1643351280000)/,84,102,0,0,41,51,0,2022-01-28 01:28:00
4346.5,52,68,4347.0,4345.75,4346.5,13,/Date(1643351340000)/,156,215,0,0,104,147,0,2022-01-28 01:29:00
4346.5,32,35,4347.0,4346.0,4346.5,13,/Date(1643351400000)/,57,65,0,0,25,30,0,2022-01-28 01:30:00
4344.75,80,96,4347.0,4344.75,4347.0,13,/Date(1643351460000)/,111,141,0,0,31,45,0,2022-01-28 01:31:00
4344.25,65,71,4345.75,4343.75,4344.75,13,/Date(1643351520000)/,99,105,0,0,34,34,0,2022-01-28 01:32:00
4344.5,44,53,4345.0,4344.0,4344.5,13,/Date(1643351580000)/,94,107,0,0,50,54,0,2022-01-28 01:33:00
4343.75,73,77,4344.75,4342.75,4344.75,13,/Date(1643351640000)/,157,164,0,0,84,87,0,2022-01-28 01:34:00
4345.0,135,164,4345.25,4343.0,4343.5,13,/Date(1643351700000)/,236,268,0,0,101,104,0,2022-01-28 01:35:00
4346.5,45,47,4346.5,4344.5,4345.0,13,/Date(1643351760000)/,99,106,0,0,54,59,0,2022-01-28 01:36:00
4347.25,40,48,4347.5,4346.25,4346.5,13,/Date(1643351820000)/,163,187,0,0,123,139,0,2022-01-28 01:37:00
4347.5,38,43,4347.75,4346.5,4347.25,13,/Date(1643351880000)/,84,94,0,0,46,51,0,2022-01-28 01:38:00
4346.0,65,72,4347.75,4345.75,4347.5,13,/Date(1643351940000)/,111,132,0,0,46,60,0,2022-01-28 01:39:00
4347.5,72,78,4348.5,4345.25,4345.75,13,/Date(1643352000000)/,227,362,0,0,155,284,0,2022-01-28 01:40:00
4347.75,87,93,4348.0,4346.25,4347.5,13,/Date(1643352060000)/,154,162,0,0,67,69,0,2022-01-28 01:41:00
4347.25,23,26,4348.0,4347.0,4347.5,13,/Date(1643352120000)/,43,48,0,0,20,22,0,2022-01-28 01:42:00
4347.75,44,51,4348.0,4346.75,4347.0,13,/Date(1643352180000)/,129,156,0,0,85,105,0,2022-01-28 01:43:00
4348.0,25,28,4348.0,4347.25,4347.5,13,/Date(1643352240000)/,69,80,0,0,44,52,0,2022-01-28 01:44:00
4346.0,65,73,4347.75,4346.0,4347.75,13,/Date(1643352300000)/,113,125,0,0,48,52,0,2022-01-28 01:45:00
4344.5,70,80,4346.0,4344.5,4345.75,13,/Date(1643352360000)/,118,134,0,0,48,54,0,2022-01-28 01:46:00
4345.0,80,102,4346.0,4344.0,4344.5,13,/Date(1643352420000)/,162,189,0,0,82,87,0,2022-01-28 01:47:00
4345.25,36,48,4346.5,4345.0,4345.0,13,/Date(1643352480000)/,92,121,0,0,56,73,0,2022-01-28 01:48:00
4346.25,39,44,4346.25,4344.75,4345.25,13,/Date(1643352540000)/,73,80,0,0,34,36,0,2022-01-28 01:49:00
4346.75,21,28,4346.75,4345.5,4346.0,13,/Date(1643352600000)/,55,69,0,0,34,41,0,2022-01-28 01:50:00
4347.5,29,31,4347.5,4346.75,4346.75,13,/Date(1643352660000)/,95,111,0,0,66,80,0,2022-01-28 01:51:00
4346.75,55,66,4347.25,4346.5,4347.25,13,/Date(1643352720000)/,87,112,0,0,32,46,0,2022-01-28 01:52:00
4347.5,28,28,4347.5,4346.5,4346.5,13,/Date(1643352780000)/,61,78,0,0,33,50,0,2022-01-28 01:53:00
4347.75,18,20,4347.75,4346.75,4347.5,13,/Date(1643352840000)/,95,115,0,0,77,95,0,2022-01-28 01:54:00
4349.25,90,100,4349.5,4347.25,4347.5,13,/Date(1643352900000)/,292,401,0,0,202,301,0,2022-01-28 01:55:00
4349.25,70,83,4350.25,4349.0,4349.0,13,/Date(1643352960000)/,166,185,0,0,96,102,0,2022-01-28 01:56:00
4348.25,89,111,4349.25,4348.0,4349.0,13,/Date(1643353020000)/,122,151,0,0,33,40,0,2022-01-28 01:57:00
4346.0,165,199,4348.75,4345.75,4348.25,13,/Date(1643353080000)/,221,256,0,0,56,57,0,2022-01-28 01:58:00
4344.25,174,240,4346.0,4343.75,4345.75,13,/Date(1643353140000)/,329,415,0,0,155,175,0,2022-01-28 01:59:00
4343.75,76,89,4344.5,4343.0,4344.5,13,/Date(1643353200000)/,97,110,0,0,21,21,0,2022-01-28 02:00:00
4340.5,202,245,4343.75,4340.25,4343.25,13,/Date(1643353260000)/,306,354,0,0,104,109,0,2022-01-28 02:01:00
4340.25,104,112,4340.75,4339.25,4340.5,13,/Date(1643353320000)/,218,255,0,0,114,143,0,2022-01-28 02:02:00
4339.0,120,132,4340.75,4338.25,4340.5,13,/Date(1643353380000)/,196,255,0,0,76,123,0,2022-01-28 02:03:00
4338.75,62,78,4340.0,4338.25,4339.5,13,/Date(1643353440000)/,107,124,0,0,45,46,0,2022-01-28 02:04:00
4337.0,134,162,4338.75,4336.0,4338.75,13,/Date(1643353500000)/,181,222,0,0,47,60,0,2022-01-28 02:05:00
4338.75,96,100,4339.5,4335.75,4336.75,13,/Date(1643353560000)/,234,244,0,0,138,144,0,2022-01-28 02:06:00
4341.25,54,76,4341.75,4339.0,4339.0,13,/Date(1643353620000)/,248,297,0,0,194,221,0,2022-01-28 02:07:00
4342.5,99,103,4343.0,4339.5,4341.25,13,/Date(1643353680000)/,228,263,0,0,129,160,0,2022-01-28 02:08:00
4342.5,68,80,4343.5,4342.0,4342.25,13,/Date(1643353740000)/,162,196,0,0,94,116,0,2022-01-28 02:09:00
4343.5,84,108,4344.25,4342.25,4342.75,13,/Date(1643353800000)/,167,203,0,0,83,95,0,2022-01-28 02:10:00
4343.0,49,53,4344.0,4342.5,4343.25,13,/Date(1643353860000)/,121,131,0,0,72,78,0,2022-01-28 02:11:00
4342.0,109,117,4342.75,4340.5,4342.75,13,/Date(1643353920000)/,166,182,0,0,57,65,0,2022-01-28 02:12:00
4345.75,125,137,4347.0,4341.5,4341.75,13,/Date(1643353980000)/,340,371,0,0,215,234,0,2022-01-28 02:13:00
4344.25,82,91,4345.75,4344.0,4345.75,13,/Date(1643354040000)/,106,115,0,0,24,24,0,2022-01-28 02:14:00
4344.25,93,113,4344.5,4342.5,4344.25,13,/Date(1643354100000)/,180,202,0,0,87,89,0,2022-01-28 02:15:00
4341.5,122,132,4344.5,4341.5,4344.25,13,/Date(1643354160000)/,180,195,0,0,58,63,0,2022-01-28 02:16:00
4344.25,99,110,4344.5,4341.0,4341.25,13,/Date(1643354220000)/,230,255,0,0,131,145,0,2022-01-28 02:17:00
4345.25,49,54,4345.75,4343.75,4344.0,13,/Date(1643354280000)/,178,188,0,0,129,134,0,2022-01-28 02:18:00
4345.0,35,39,4345.5,4344.5,4345.5,13,/Date(1643354340000)/,69,74,0,0,34,35,0,2022-01-28 02:19:00
4343.75,47,50,4345.0,4343.5,4345.0,13,/Date(1643354400000)/,77,84,0,0,30,34,0,2022-01-28 02:20:00
4341.5,82,91,4344.25,4341.0,4344.25,13,/Date(1643354460000)/,140,151,0,0,58,60,0,2022-01-28 02:21:00
4339.75,117,174,4342.0,4339.75,4342.0,13,/Date(1643354520000)/,187,254,0,0,70,80,0,2022-01-28 02:22:00
4338.5,109,125,4340.0,4338.25,4339.5,13,/Date(1643354580000)/,184,201,0,0,75,76,0,2022-01-28 02:23:00
4336.75,112,117,4339.25,4336.75,4338.5,13,/Date(1643354640000)/,153,162,0,0,41,45,0,2022-01-28 02:24:00
4337.0,127,140,4337.75,4335.75,4336.75,13,/Date(1643354700000)/,265,307,0,0,138,167,0,2022-01-28 02:25:00
4336.25,118,131,4337.5,4335.75,4337.0,13,/Date(1643354760000)/,184,199,0,0,66,68,0,2022-01-28 02:26:00
4339.75,106,121,4340.0,4335.75,4336.25,13,/Date(1643354820000)/,263,302,0,0,157,181,0,2022-01-28 02:27:00
4342.25,71,79,4342.25,4339.75,4339.75,13,/Date(1643354880000)/,194,219,0,0,123,140,0,2022-01-28 02:28:00
4341.5,221,242,4343.75,4341.25,4342.0,13,/Date(1643354940000)/,410,444,0,0,189,202,0,2022-01-28 02:29:00
4341.0,56,61,4342.0,4340.75,4341.25,13,/Date(1643355000000)/,126,138,0,0,70,77,0,2022-01-28 02:30:00
4339.25,94,95,4341.5,4338.75,4341.0,13,/Date(1643355060000)/,168,172,0,0,74,77,0,2022-01-28 02:31:00
4338.0,38,38,4339.25,4337.75,4339.25,13,/Date(1643355120000)/,88,95,0,0,50,57,0,2022-01-28 02:32:00
4339.75,64,67,4340.0,4337.25,4337.75,13,/Date(1643355180000)/,181,193,0,0,117,126,0,2022-01-28 02:33:00
4339.0,114,129,4340.0,4338.25,4339.75,13,/Date(1643355240000)/,183,213,0,0,69,84,0,2022-01-28 02:34:00
4337.0,81,92,4338.75,4336.75,4338.75,13,/Date(1643355300000)/,142,167,0,0,61,75,0,2022-01-28 02:35:00
4337.75,161,183,4338.5,4336.5,4337.5,13,/Date(1643355360000)/,283,313,0,0,122,130,0,2022-01-28 02:36:00
4339.25,117,120,4340.0,4336.75,4338.0,13,/Date(1643355420000)/,256,314,0,0,139,194,0,2022-01-28 02:37:00
4339.0,139,182,4339.75,4338.0,4339.25,13,/Date(1643355480000)/,285,336,0,0,146,154,0,2022-01-28 02:38:00
4340.0,51,58,4340.5,4338.5,4339.0,13,/Date(1643355540000)/,129,147,0,0,78,89,0,2022-01-28 02:39:00
4340.5,31,34,4340.5,4339.25,4339.75,13,/Date(1643355600000)/,87,91,0,0,56,57,0,2022-01-28 02:40:00
4340.25,69,86,4341.0,4339.0,4340.5,13,/Date(1643355660000)/,183,207,0,0,114,121,0,2022-01-28 02:41:00
4341.0,95,102,4342.0,4340.5,4340.5,13,/Date(1643355720000)/,178,193,0,0,83,91,0,2022-01-28 02:42:00
4338.75,108,116,4341.0,4338.75,4341.0,13,/Date(1643355780000)/,147,164,0,0,39,48,0,2022-01-28 02:43:00
4340.75,87,90,4340.75,4338.0,4338.75,13,/Date(1643355840000)/,238,258,0,0,151,168,0,2022-01-28 02:44:00
4339.5,88,91,4341.5,4339.5,4340.75,13,/Date(1643355900000)/,139,143,0,0,51,52,0,2022-01-28 02:45:00
4338.75,146,154,4340.25,4337.75,4339.5,13,/Date(1643355960000)/,278,319,0,0,132,165,0,2022-01-28 02:46:00
4338.0,116,129,4339.25,4337.25,4338.5,13,/Date(1643356020000)/,247,270,0,0,131,141,0,2022-01-28 02:47:00
4337.5,183,202,4338.75,4336.75,4338.0,13,/Date(1643356080000)/,355,463,0,0,172,261,0,2022-01-28 02:48:00
4340.5,32,41,4340.5,4337.5,4337.5,13,/Date(1643356140000)/,176,197,0,0,144,156,0,2022-01-28 02:49:00
4343.25,134,141,4344.25,4340.25,4340.25,13,/Date(1643356200000)/,393,421,0,0,259,280,0,2022-01-28 02:50:00
4342.25,170,189,4343.75,4341.25,4343.0,13,/Date(1643356260000)/,322,352,0,0,152,163,0,2022-01-28 02:51:00
4344.5,103,142,4344.75,4342.0,4342.25,13,/Date(1643356320000)/,257,312,0,0,154,170,0,2022-01-28 02:52:00
4347.25,157,169,4348.0,4343.75,4344.25,13,/Date(1643356380000)/,428,478,0,0,271,309,0,2022-01-28 02:53:00
4348.75,205,314,4348.75,4347.0,4347.0,13,/Date(1643356440000)/,431,572,0,0,226,258,0,2022-01-28 02:54:00
4348.75,203,323,4350.0,4348.25,4348.75,13,/Date(1643356500000)/,454,640,0,0,251,317,0,2022-01-28 02:55:00
4347.0,200,240,4349.0,4346.75,4349.0,13,/Date(1643356560000)/,331,377,0,0,131,137,0,2022-01-28 02:56:00
4346.25,123,127,4347.5,4346.25,4347.25,13,/Date(1643356620000)/,234,262,0,0,111,135,0,2022-01-28 02:57:00
4345.25,190,226,4346.0,4344.75,4346.0,13,/Date(1643356680000)/,274,313,0,0,84,87,0,2022-01-28 02:58:00
4345.0,154,159,4346.0,4344.25,4345.25,13,/Date(1643356740000)/,327,368,0,0,173,209,0,2022-01-28 02:59:00
4345.0,209,244,4345.5,4343.0,4344.75,13,/Date(1643356800000)/,490,639,0,0,281,395,0,2022-01-28 03:00:00
4340.75,886,954,4345.25,4340.25,4345.0,13,/Date(1643356860000)/,1529,1679,0,0,643,725,0,2022-01-28 03:01:00
4343.5,346,369,4344.0,4340.5,4340.75,13,/Date(1643356920000)/,726,771,0,0,380,402,0,2022-01-28 03:02:00
4340.0,442,500,4344.5,4339.25,4343.75,13,/Date(1643356980000)/,773,872,0,0,331,372,0,2022-01-28 03:03:00
4340.75,257,314,4342.5,4339.5,4340.0,13,/Date(1643357040000)/,601,726,0,0,344,412,0,2022-01-28 03:04:00
4339.0,212,226,4341.0,4338.5,4341.0,13,/Date(1643357100000)/,349,382,0,0,137,156,0,2022-01-28 03:05:00
4337.0,273,303,4339.0,4336.75,4339.0,13,/Date(1643357160000)/,459,499,0,0,186,196,0,2022-01-28 03:06:00
4339.25,387,549,4339.75,4334.75,4337.25,13,/Date(1643357220000)/,748,979,0,0,361,430,0,2022-01-28 03:07:00
4336.75,214,228,4340.5,4336.25,4339.25,13,/Date(1643357280000)/,373,394,0,0,159,166,0,2022-01-28 03:08:00
4334.75,206,235,4337.25,4334.5,4336.75,13,/Date(1643357340000)/,365,426,0,0,159,191,0,2022-01-28 03:09:00
4335.5,332,462,4336.75,4333.5,4334.75,13,/Date(1643357400000)/,551,713,0,0,219,251,0,2022-01-28 03:10:00
4331.0,349,400,4335.5,4330.75,4335.5,13,/Date(1643357460000)/,539,652,0,0,190,252,0,2022-01-28 03:11:00
4329.75,555,716,4331.75,4327.75,4331.0,13,/Date(1643357520000)/,969,1192,0,0,414,476,0,2022-01-28 03:12:00
4328.5,151,190,4330.25,4328.0,4329.5,13,/Date(1643357580000)/,309,373,0,0,158,183,0,2022-01-28 03:13:00
4330.0,240,271,4331.25,4327.25,4328.75,13,/Date(1643357640000)/,487,547,0,0,247,276,0,2022-01-28 03:14:00
4324.75,441,573,4330.0,4324.75,4330.0,13,/Date(1643357700000)/,666,843,0,0,225,270,0,2022-01-28 03:15:00
4326.0,269,307,4326.75,4324.0,4324.75,13,/Date(1643357760000)/,553,656,0,0,284,349,0,2022-01-28 03:16:00
4323.5,427,518,4326.0,4322.5,4326.0,13,/Date(1643357820000)/,766,922,0,0,339,404,0,2022-01-28 03:17:00
4323.25,207,275,4325.25,4322.75,4323.75,13,/Date(1643357880000)/,414,525,0,0,207,250,0,2022-01-28 03:18:00
4324.5,182,239,4325.75,4322.5,4323.25,13,/Date(1643357940000)/,438,532,0,0,256,293,0,2022-01-28 03:19:00
4319.25,705,964,4325.25,4318.75,4324.75,13,/Date(1643358000000)/,1160,1488,0,0,455,524,0,2022-01-28 03:20:00
4314.75,862,1176,4319.5,4313.75,4319.25,13,/Date(1643358060000)/,1403,1833,0,0,541,657,0,2022-01-28 03:21:00
4312.25,599,740,4316.5,4311.5,4314.75,13,/Date(1643358120000)/,1289,1551,0,0,690,811,0,2022-01-28 03:22:00
4312.5,610,790,4315.0,4310.25,4312.25,13,/Date(1643358180000)/,1172,1455,0,0,562,665,0,2022-01-28 03:23:00
4313.25,434,557,4314.0,4311.5,4312.25,13,/Date(1643358240000)/,883,1133,0,0,449,576,0,2022-01-28 03:24:00
4317.0,334,417,4317.5,4312.75,4313.25,13,/Date(1643358300000)/,817,1053,0,0,483,636,0,2022-01-28 03:25:00
4315.75,364,566,4317.5,4314.75,4317.25,13,/Date(1643358360000)/,735,980,0,0,371,414,0,2022-01-28 03:26:00
4317.5,205,273,4318.25,4314.25,4315.25,13,/Date(1643358420000)/,565,681,0,0,360,408,0,2022-01-28 03:27:00
4321.0,322,413,4321.75,4317.0,4317.25,13,/Date(1643358480000)/,916,1142,0,0,594,729,0,2022-01-28 03:28:00
4319.5,287,397,4321.25,4318.0,4321.25,13,/Date(1643358540000)/,601,758,0,0,314,361,0,2022-01-28 03:29:00
4316.5,419,479,4320.5,4316.5,4319.25,13,/Date(1643358600000)/,744,911,0,0,325,432,0,2022-01-28 03:30:00
4316.5,248,313,4320.0,4316.25,4316.25,13,/Date(1643358660000)/,520,614,0,0,272,301,0,2022-01-28 03:31:00
4314.0,272,339,4317.0,4314.0,4316.75,13,/Date(1643358720000)/,396,497,0,0,124,158,0,2022-01-28 03:32:00
4315.25,321,368,4315.25,4312.0,4313.75,13,/Date(1643358780000)/,608,691,0,0,287,323,0,2022-01-28 03:33:00
4314.75,337,401,4317.75,4313.25,4314.75,13,/Date(1643358840000)/,813,997,0,0,476,596,0,2022-01-28 03:34:00
4317.25,195,246,4317.5,4314.0,4315.0,13,/Date(1643358900000)/,436,515,0,0,241,269,0,2022-01-28 03:35:00
4320.25,263,274,4321.0,4317.25,4317.25,13,/Date(1643358960000)/,590,621,0,0,327,347,0,2022-01-28 03:36:00
4317.5,282,358,4320.75,4317.25,4320.0,13,/Date(1643359020000)/,466,553,0,0,184,195,0,2022-01-28 03:37:00
4319.5,208,223,4320.0,4316.25,4317.0,13,/Date(1643359080000)/,519,582,0,0,311,359,0,2022-01-28 03:38:00
4320.0,231,281,4321.75,4317.25,4319.25,13,/Date(1643359140000)/,522,624,0,0,291,343,0,2022-01-28 03:39:00
4322.5,161,171,4323.0,4318.25,4320.0,13,/Date(1643359200000)/,471,511,0,0,310,340,0,2022-01-28 03:40:00
4321.75,224,255,4324.0,4321.25,4322.5,13,/Date(1643359260000)/,461,532,0,0,237,277,0,2022-01-28 03:41:00
4322.25,227,244,4324.0,4320.25,4321.75,13,/Date(1643359320000)/,402,461,0,0,175,217,0,2022-01-28 03:42:00
4322.75,130,141,4323.25,4321.0,4322.0,13,/Date(1643359380000)/,290,311,0,0,160,170,0,2022-01-28 03:43:00
4323.75,131,141,4324.25,4321.75,4322.75,13,/Date(1643359440000)/,287,315,0,0,156,174,0,2022-01-28 03:44:00
4320.5,210,286,4324.0,4320.0,4323.75,13,/Date(1643359500000)/,386,482,0,0,176,196,0,2022-01-28 03:45:00
4320.5,194,229,4320.5,4318.25,4320.5,13,/Date(1643359560000)/,392,441,0,0,198,212,0,2022-01-28 03:46:00
4322.25,144,168,4322.5,4319.75,4320.5,13,/Date(1643359620000)/,335,368,0,0,191,200,0,2022-01-28 03:47:00
4326.75,224,230,4326.75,4321.5,4321.75,13,/Date(1643359680000)/,569,664,0,0,345,434,0,2022-01-28 03:48:00
4326.75,399,584,4329.5,4326.5,4326.75,13,/Date(1643359740000)/,846,1146,0,0,447,562,0,2022-01-28 03:49:00
4323.5,306,365,4326.75,4322.5,4326.75,13,/Date(1643359800000)/,533,598,0,0,227,233,0,2022-01-28 03:50:00
4326.5,176,188,4327.0,4322.25,4323.5,13,/Date(1643359860000)/,503,586,0,0,327,398,0,2022-01-28 03:51:00
4326.0,168,189,4327.5,4325.25,4326.25,13,/Date(1643359920000)/,353,395,0,0,185,206,0,2022-01-28 03:52:00
4324.75,135,161,4327.5,4324.5,4326.25,13,/Date(1643359980000)/,301,359,0,0,166,198,0,2022-01-28 03:53:00
4323.75,177,197,4325.5,4323.0,4324.75,13,/Date(1643360040000)/,315,341,0,0,138,144,0,2022-01-28 03:54:00
4326.75,87,97,4327.0,4323.25,4323.5,13,/Date(1643360100000)/,299,332,0,0,212,235,0,2022-01-28 03:55:00
4325.5,224,308,4327.5,4325.0,4327.0,13,/Date(1643360160000)/,404,500,0,0,180,192,0,2022-01-28 03:56:00
4322.75,183,208,4326.25,4322.5,4325.25,13,/Date(1643360220000)/,388,471,0,0,205,263,0,2022-01-28 03:57:00
4324.5,196,287,4324.75,4320.25,4322.75,13,/Date(1643360280000)/,403,520,0,0,207,233,0,2022-01-28 03:58:00
4327.5,121,128,4327.75,4323.75,4324.5,13,/Date(1643360340000)/,299,327,0,0,178,199,0,2022-01-28 03:59:00
4327.0,124,127,4328.75,4326.5,4327.75,13,/Date(1643360400000)/,271,295,0,0,147,168,0,2022-01-28 04:00:00
4329.5,242,263,4329.75,4325.75,4327.0,13,/Date(1643360460000)/,574,622,0,0,332,359,0,2022-01-28 04:01:00
4325.0,419,586,4329.75,4325.0,4329.75,13,/Date(1643360520000)/,630,820,0,0,211,234,0,2022-01-28 04:02:00
4324.25,186,197,4325.75,4322.5,4325.0,13,/Date(1643360580000)/,356,393,0,0,170,196,0,2022-01-28 04:03:00
4321.5,238,258,4325.0,4321.5,4324.0,13,/Date(1643360640000)/,428,500,0,0,190,242,0,2022-01-28 04:04:00
4321.0,162,180,4323.25,4320.25,4321.25,13,/Date(1643360700000)/,306,391,0,0,144,211,0,2022-01-28 04:05:00
4320.25,195,228,4322.25,4319.0,4320.75,13,/Date(1643360760000)/,379,464,0,0,184,236,0,2022-01-28 04:06:00
4320.5,183,197,4320.75,4318.0,4320.25,13,/Date(1643360820000)/,355,392,0,0,172,195,0,2022-01-28 04:07:00
4317.0,246,305,4321.25,4316.0,4320.5,13,/Date(1643360880000)/,407,533,0,0,161,228,0,2022-01-28 04:08:00
4317.5,210,213,4318.75,4316.5,4317.0,13,/Date(1643360940000)/,422,453,0,0,212,240,0,2022-01-28 04:09:00
4319.0,131,136,4319.0,4317.0,4317.5,13,/Date(1643361000000)/,328,407,0,0,197,271,0,2022-01-28 04:10:00
4322.0,166,192,4322.0,4318.0,4319.0,13,/Date(1643361060000)/,402,483,0,0,236,291,0,2022-01-28 04:11:00
4325.0,237,264,4325.5,4321.0,4321.75,13,/Date(1643361120000)/,536,626,0,0,299,362,0,2022-01-28 04:12:00
4326.5,239,265,4326.75,4323.5,4325.25,13,/Date(1643361180000)/,547,654,0,0,308,389,0,2022-01-28 04:13:00
4330.0,190,210,4330.25,4325.25,4326.25,13,/Date(1643361240000)/,512,611,0,0,322,401,0,2022-01-28 04:14:00
4331.5,257,363,4332.75,4329.25,4330.0,13,/Date(1643361300000)/,585,778,0,0,328,415,0,2022-01-28 04:15:00
4332.5,268,292,4334.0,4330.75,4331.5,13,/Date(1643361360000)/,660,788,0,0,392,496,0,2022-01-28 04:16:00
4330.5,258,298,4332.5,4330.0,4332.5,13,/Date(1643361420000)/,450,519,0,0,192,221,0,2022-01-28 04:17:00
4329.0,209,273,4331.25,4328.75,4330.75,13,/Date(1643361480000)/,396,543,0,0,187,270,0,2022-01-28 04:18:00
4328.25,156,167,4329.0,4327.5,4328.75,13,/Date(1643361540000)/,305,352,0,0,149,185,0,2022-01-28 04:19:00
4327.25,149,180,4328.5,4327.0,4328.0,13,/Date(1643361600000)/,291,369,0,0,142,189,0,2022-01-28 04:20:00
4327.5,147,166,4328.25,4326.5,4327.0,13,/Date(1643361660000)/,312,351,0,0,165,185,0,2022-01-28 04:21:00
4326.0,165,198,4328.0,4325.25,4327.75,13,/Date(1643361720000)/,302,346,0,0,137,148,0,2022-01-28 04:22:00
4329.5,146,158,4330.25,4325.5,4325.75,13,/Date(1643361780000)/,355,391,0,0,209,233,0,2022-01-28 04:23:00
4331.5,146,155,4332.75,4330.0,4330.0,13,/Date(1643361840000)/,356,411,0,0,210,256,0,2022-01-28 04:24:00
4329.0,128,140,4331.25,4328.5,4331.25,13,/Date(1643361900000)/,242,274,0,0,114,134,0,2022-01-28 04:25:00
4327.5,138,167,4331.0,4327.5,4329.0,13,/Date(1643361960000)/,238,273,0,0,100,106,0,2022-01-28 04:26:00
4328.5,113,126,4330.0,4327.25,4327.5,13,/Date(1643362020000)/,191,213,0,0,78,87,0,2022-01-28 04:27:00
4328.25,56,59,4329.5,4328.0,4328.5,13,/Date(1643362080000)/,119,123,0,0,63,64,0,2022-01-28 04:28:00
4327.75,84,89,4329.25,4327.25,4328.0,13,/Date(1643362140000)/,163,169,0,0,79,80,0,2022-01-28 04:29:00
4324.0,207,237,4327.5,4323.75,4327.5,13,/Date(1643362200000)/,384,448,0,0,177,211,0,2022-01-28 04:30:00
4327.5,142,158,4328.0,4323.75,4324.0,13,/Date(1643362260000)/,351,425,0,0,209,267,0,2022-01-28 04:31:00
4325.5,241,266,4329.5,4325.5,4327.75,13,/Date(1643362320000)/,378,436,0,0,137,170,0,2022-01-28 04:32:00
4326.5,241,326,4326.5,4322.0,4325.75,13,/Date(1643362380000)/,430,521,0,0,189,195,0,2022-01-28 04:33:00
4326.5,129,143,4328.0,4325.75,4326.25,13,/Date(1643362440000)/,242,280,0,0,113,137,0,2022-01-28 04:34:00
4324.0,156,162,4327.0,4323.5,4326.5,13,/Date(1643362500000)/,236,247,0,0,80,85,0,2022-01-28 04:35:00
4324.0,136,164,4325.5,4323.5,4323.75,13,/Date(1643362560000)/,222,251,0,0,86,87,0,2022-01-28 04:36:00
4321.5,144,178,4324.25,4321.0,4323.75,13,/Date(1643362620000)/,247,288,0,0,103,110,0,2022-01-28 04:37:00
4322.0,259,318,4323.25,4319.75,4321.5,13,/Date(1643362680000)/,451,551,0,0,192,233,0,2022-01-28 04:38:00
4322.5,122,139,4322.75,4320.25,4322.0,13,/Date(1643362740000)/,243,270,0,0,121,131,0,2022-01-28 04:39:00
4322.0,138,165,4323.0,4320.5,4322.25,13,/Date(1643362800000)/,282,351,0,0,144,186,0,2022-01-28 04:40:00
4321.5,168,225,4323.25,4320.5,4322.25,13,/Date(1643362860000)/,286,352,0,0,118,127,0,2022-01-28 04:41:00
4322.25,165,188,4323.5,4320.75,4321.5,13,/Date(1643362920000)/,318,386,0,0,153,198,0,2022-01-28 04:42:00
4322.0,147,186,4322.5,4320.5,4322.0,13,/Date(1643362980000)/,281,336,0,0,134,150,0,2022-01-28 04:43:00
4325.75,109,134,4326.5,4322.0,4322.25,13,/Date(1643363040000)/,306,358,0,0,197,224,0,2022-01-28 04:44:00
4327.75,141,154,4328.0,4325.0,4325.5,13,/Date(1643363100000)/,348,408,0,0,207,254,0,2022-01-28 04:45:00
4328.75,114,131,4329.25,4326.0,4327.75,13,/Date(1643363160000)/,251,281,0,0,137,150,0,2022-01-28 04:46:00
4326.5,175,189,4329.25,4325.25,4329.0,13,/Date(1643363220000)/,317,364,0,0,142,175,0,2022-01-28 04:47:00
4324.5,171,181,4327.25,4323.75,4326.5,13,/Date(1643363280000)/,307,350,0,0,136,169,0,2022-01-28 04:48:00
4325.25,93,101,4326.75,4324.25,4324.5,13,/Date(1643363340000)/,155,165,0,0,62,64,0,2022-01-28 04:49:00
4322.0,247,302,4325.0,4319.5,4325.0,13,/Date(1643363400000)/,437,535,0,0,190,233,0,2022-01-28 04:50:00
4320.5,99,130,4323.25,4320.0,4322.0,13,/Date(1643363460000)/,232,281,0,0,133,151,0,2022-01-28 04:51:00
4320.25,154,186,4321.0,4319.25,4320.75,13,/Date(1643363520000)/,295,373,0,0,141,187,0,2022-01-28 04:52:00
4321.25,106,137,4321.75,4319.0,4320.0,13,/Date(1643363580000)/,198,248,0,0,92,111,0,2022-01-28 04:53:00
4320.75,161,216,4322.0,4319.25,4321.25,13,/Date(1643363640000)/,272,339,0,0,111,123,0,2022-01-28 04:54:00
4322.0,106,137,4322.25,4320.0,4321.0,13,/Date(1643363700000)/,234,295,0,0,128,158,0,2022-01-28 04:55:00
4322.5,134,152,4323.75,4321.75,4322.0,13,/Date(1643363760000)/,256,299,0,0,122,147,0,2022-01-28 04:56:00
4319.5,165,211,4322.75,4318.5,4322.75,13,/Date(1643363820000)/,248,313,0,0,83,102,0,2022-01-28 04:57:00
4319.0,133,180,4320.5,4317.5,4319.25,13,/Date(1643363880000)/,240,293,0,0,107,113,0,2022-01-28 04:58:00
4320.75,91,98,4321.0,4317.75,4319.0,13,/Date(1643363940000)/,234,263,0,0,143,165,0,2022-01-28 04:59:00
4321.25,66,77,4321.25,4320.0,4320.75,13,/Date(1643364000000)/,135,147,0,0,69,70,0,2022-01-28 05:00:00
4319.75,99,109,4321.5,4319.25,4321.0,13,/Date(1643364060000)/,167,180,0,0,68,71,0,2022-01-28 05:01:00
4319.5,65,83,4319.75,4318.5,4319.75,13,/Date(1643364120000)/,153,172,0,0,88,89,0,2022-01-28 05:02:00
4317.5,350,457,4319.25,4314.75,4319.25,13,/Date(1643364180000)/,683,842,0,0,333,385,0,2022-01-28 05:03:00
4317.0,197,214,4318.5,4316.0,4317.25,13,/Date(1643364240000)/,388,419,0,0,191,205,0,2022-01-28 05:04:00
4317.5,172,191,4318.25,4315.5,4317.25,13,/Date(1643364300000)/,336,364,0,0,164,173,0,2022-01-28 05:05:00
4315.75,201,227,4318.0,4314.75,4317.75,13,/Date(1643364360000)/,317,365,0,0,116,138,0,2022-01-28 05:06:00
4317.0,138,157,4317.0,4314.0,4315.5,13,/Date(1643364420000)/,280,331,0,0,142,174,0,2022-01-28 05:07:00
4316.0,91,104,4317.5,4315.25,4316.75,13,/Date(1643364480000)/,186,202,0,0,95,98,0,2022-01-28 05:08:00
4315.0,218,264,4316.5,4314.0,4315.75,13,/Date(1643364540000)/,324,386,0,0,106,122,0,2022-01-28 05:09:00
4310.75,619,827,4315.25,4310.5,4315.0,13,/Date(1643364600000)/,962,1303,0,0,343,476,0,2022-01-28 05:10:00
4314.75,245,288,4315.5,4310.75,4310.75,13,/Date(1643364660000)/,648,819,0,0,403,531,0,2022-01-28 05:11:00
4314.25,133,155,4315.5,4313.25,4315.0,13,/Date(1643364720000)/,242,271,0,0,109,116,0,2022-01-28 05:12:00
4314.5,100,123,4316.25,4313.5,4314.0,13,/Date(1643364780000)/,182,210,0,0,82,87,0,2022-01-28 05:13:00
4315.25,113,137,4316.0,4313.25,4314.5,13,/Date(1643364840000)/,204,234,0,0,91,97,0,2022-01-28 05:14:00
4315.75,161,178,4316.75,4315.0,4315.25,13,/Date(1643364900000)/,290,322,0,0,129,144,0,2022-01-28 05:15:00
4314.0,245,295,4316.0,4312.75,4316.0,13,/Date(1643364960000)/,383,453,0,0,138,158,0,2022-01-28 05:16:00
4308.75,563,861,4313.75,4308.25,4313.75,13,/Date(1643365020000)/,783,1120,0,0,220,259,0,2022-01-28 05:17:00
4310.0,230,255,4310.75,4308.25,4308.5,13,/Date(1643365080000)/,462,502,0,0,232,247,0,2022-01-28 05:18:00
4309.25,179,220,4311.25,4308.75,4310.0,13,/Date(1643365140000)/,311,383,0,0,132,163,0,2022-01-28 05:19:00
4309.0,126,139,4310.0,4308.5,4309.25,13,/Date(1643365200000)/,193,237,0,0,67,98,0,2022-01-28 05:20:00
4307.25,204,266,4309.25,4307.0,4308.75,13,/Date(1643365260000)/,338,410,0,0,134,144,0,2022-01-28 05:21:00
4310.0,300,347,4310.25,4306.5,4307.25,13,/Date(1643365320000)/,822,990,0,0,522,643,0,2022-01-28 05:22:00
4311.75,153,170,4312.5,4309.0,4309.75,13,/Date(1643365380000)/,408,438,0,0,255,268,0,2022-01-28 05:23:00
4314.5,180,248,4314.75,4311.75,4311.75,13,/Date(1643365440000)/,442,547,0,0,262,299,0,2022-01-28 05:24:00
4315.5,91,115,4316.0,4313.5,4314.5,13,/Date(1643365500000)/,224,276,0,0,133,161,0,2022-01-28 05:25:00
4317.5,207,230,4318.75,4314.75,4315.5,13,/Date(1643365560000)/,483,550,0,0,276,320,0,2022-01-28 05:26:00
4317.5,124,174,4317.5,4315.75,4317.25,13,/Date(1643365620000)/,222,279,0,0,98,105,0,2022-01-28 05:27:00
4316.75,86,99,4318.25,4316.25,4317.5,13,/Date(1643365680000)/,179,228,0,0,93,129,0,2022-01-28 05:28:00
4316.0,127,148,4318.75,4316.0,4317.0,13,/Date(1643365740000)/,265,320,0,0,138,172,0,2022-01-28 05:29:00
4312.25,285,306,4315.75,4312.0,4315.75,13,/Date(1643365800000)/,454,504,0,0,169,198,0,2022-01-28 05:30:00
4314.25,135,148,4315.0,4312.25,4312.25,13,/Date(1643365860000)/,307,353,0,0,172,205,0,2022-01-28 05:31:00
4312.25,93,102,4314.0,4312.0,4314.0,13,/Date(1643365920000)/,142,159,0,0,49,57,0,2022-01-28 05:32:00
4312.5,113,115,4313.75,4311.25,4312.25,13,/Date(1643365980000)/,225,231,0,0,112,116,0,2022-01-28 05:33:00
4310.25,128,175,4313.5,4310.0,4312.5,13,/Date(1643366040000)/,199,248,0,0,71,73,0,2022-01-28 05:34:00
4310.0,145,171,4310.75,4309.25,4310.0,13,/Date(1643366100000)/,247,282,0,0,102,111,0,2022-01-28 05:35:00
4307.25,226,262,4309.5,4307.0,4309.5,13,/Date(1643366160000)/,366,413,0,0,140,151,0,2022-01-28 05:36:00
4306.25,234,304,4307.75,4305.0,4307.75,13,/Date(1643366220000)/,405,535,0,0,171,231,0,2022-01-28 05:37:00
4309.0,143,147,4309.75,4306.0,4306.25,13,/Date(1643366280000)/,343,379,0,0,200,232,0,2022-01-28 05:38:00
4306.0,165,208,4309.5,4305.75,4309.0,13,/Date(1643366340000)/,277,330,0,0,112,122,0,2022-01-28 05:39:00
4304.5,298,437,4307.0,4304.25,4305.75,13,/Date(1643366400000)/,478,649,0,0,180,212,0,2022-01-28 05:40:00
4306.5,135,159,4306.75,4304.75,4304.75,13,/Date(1643366460000)/,344,424,0,0,209,265,0,2022-01-28 05:41:00
4309.75,197,228,4310.5,4306.5,4306.75,13,/Date(1643366520000)/,434,507,0,0,237,279,0,2022-01-28 05:42:00
4309.5,206,310,4310.5,4308.0,4309.75,13,/Date(1643366580000)/,492,744,0,0,286,434,0,2022-01-28 05:43:00
4310.5,115,176,4311.0,4308.25,4309.25,13,/Date(1643366640000)/,402,546,0,0,287,370,0,2022-01-28 05:44:00
4311.75,148,169,4312.25,4310.5,4310.5,13,/Date(1643366700000)/,345,401,0,0,197,232,0,2022-01-28 05:45:00
4311.0,217,281,4313.0,4310.25,4311.75,13,/Date(1643366760000)/,381,497,0,0,164,216,0,2022-01-28 05:46:00
4312.25,207,245,4312.75,4310.75,4311.0,13,/Date(1643366820000)/,356,449,0,0,149,204,0,2022-01-28 05:47:00
4311.5,115,134,4312.5,4310.5,4312.25,13,/Date(1643366880000)/,200,251,0,0,85,117,0,2022-01-28 05:48:00
4314.5,138,153,4314.75,4310.5,4311.5,13,/Date(1643366940000)/,327,402,0,0,189,249,0,2022-01-28 05:49:00
4311.5,190,238,4314.75,4311.25,4314.25,13,/Date(1643367000000)/,326,411,0,0,136,173,0,2022-01-28 05:50:00
4309.5,211,307,4312.0,4309.0,4312.0,13,/Date(1643367060000)/,313,429,0,0,102,122,0,2022-01-28 05:51:00
4308.75,97,112,4309.75,4308.25,4309.5,13,/Date(1643367120000)/,235,281,0,0,138,169,0,2022-01-28 05:52:00
4306.5,150,178,4308.5,4306.0,4308.5,13,/Date(1643367180000)/,279,323,0,0,129,145,0,2022-01-28 05:53:00
4308.0,129,138,4308.0,4306.25,4306.25,13,/Date(1643367240000)/,342,429,0,0,213,291,0,2022-01-28 05:54:00
4307.0,154,175,4309.5,4307.0,4307.75,13,/Date(1643367300000)/,248,300,0,0,94,125,0,2022-01-28 05:55:00
4305.0,349,444,4307.75,4304.0,4307.0,13,/Date(1643367360000)/,572,706,0,0,223,262,0,2022-01-28 05:56:00
4305.25,227,255,4306.5,4304.0,4304.75,13,/Date(1643367420000)/,457,563,0,0,230,308,0,2022-01-28 05:57:00
4308.5,151,162,4309.5,4305.5,4305.5,13,/Date(1643367480000)/,434,493,0,0,283,331,0,2022-01-28 05:58:00
4308.25,123,135,4310.25,4308.0,4308.5,13,/Date(1643367540000)/,317,370,0,0,194,235,0,2022-01-28 05:59:00
4310.75,149,195,4311.75,4307.5,4308.0,13,/Date(1643367600000)/,368,488,0,0,219,293,0,2022-01-28 06:00:00
4311.75,269,307,4312.5,4309.25,4311.0,13,/Date(1643367660000)/,601,756,0,0,332,449,0,2022-01-28 06:01:00
4312.75,177,225,4314.0,4311.25,4311.5,13,/Date(1643367720000)/,376,483,0,0,199,258,0,2022-01-28 06:02:00
4310.75,128,149,4312.75,4310.75,4312.5,13,/Date(1643367780000)/,207,240,0,0,79,91,0,2022-01-28 06:03:00
4308.25,240,293,4311.25,4307.5,4310.75,13,/Date(1643367840000)/,343,426,0,0,103,133,0,2022-01-28 06:04:00
4309.0,156,208,4309.25,4307.25,4308.0,13,/Date(1643367900000)/,264,331,0,0,108,123,0,2022-01-28 06:05:00
4307.5,117,141,4309.0,4305.75,4308.75,13,/Date(1643367960000)/,264,303,0,0,147,162,0,2022-01-28 06:06:00
4308.25,95,96,4308.5,4307.25,4307.25,13,/Date(1643368020000)/,175,177,0,0,80,81,0,2022-01-28 06:07:00
4307.25,217,266,4311.0,4307.25,4308.0,13,/Date(1643368080000)/,357,421,0,0,140,155,0,2022-01-28 06:08:00
4305.75,269,310,4308.75,4304.25,4307.25,13,/Date(1643368140000)/,448,516,0,0,179,206,0,2022-01-28 06:09:00
4306.5,162,194,4306.75,4305.75,4306.0,13,/Date(1643368200000)/,313,381,0,0,151,187,0,2022-01-28 06:10:00
4304.0,336,389,4306.75,4304.0,4306.5,13,/Date(1643368260000)/,526,624,0,0,190,235,0,2022-01-28 06:11:00
4303.75,305,389,4305.0,4303.0,4304.25,13,/Date(1643368320000)/,495,628,0,0,190,239,0,2022-01-28 06:12:00
4303.5,170,194,4305.25,4303.0,4304.0,13,/Date(1643368380000)/,387,492,0,0,217,298,0,2022-01-28 06:13:00
4306.25,152,163,4307.5,4303.25,4303.5,13,/Date(1643368440000)/,350,409,0,0,198,246,0,2022-01-28 06:14:00
4301.25,418,497,4306.0,4301.0,4306.0,13,/Date(1643368500000)/,659,798,0,0,241,301,0,2022-01-28 06:15:00
4300.5,535,789,4301.75,4300.0,4301.5,13,/Date(1643368560000)/,928,1260,0,0,393,471,0,2022-01-28 06:16:00
4302.5,179,217,4302.75,4300.25,4300.5,13,/Date(1643368620000)/,492,585,0,0,313,368,0,2022-01-28 06:17:00
4297.0,677,905,4302.75,4296.5,4302.25,13,/Date(1643368680000)/,1014,1394,0,0,337,489,0,2022-01-28 06:18:00
4295.25,746,961,4297.0,4293.25,4296.75,13,/Date(1643368740000)/,1329,1875,0,0,583,914,0,2022-01-28 06:19:00
4294.25,527,654,4296.0,4292.25,4295.25,13,/Date(1643368800000)/,931,1138,0,0,404,484,0,2022-01-28 06:20:00
4298.25,293,363,4298.25,4294.5,4294.5,13,/Date(1643368860000)/,716,835,0,0,423,472,0,2022-01-28 06:21:00
4294.5,350,404,4298.5,4293.5,4298.25,13,/Date(1643368920000)/,564,642,0,0,214,238,0,2022-01-28 06:22:00
4293.75,291,345,4296.0,4292.25,4294.25,13,/Date(1643368980000)/,593,661,0,0,302,316,0,2022-01-28 06:23:00
4298.75,237,300,4299.25,4293.75,4293.75,13,/Date(1643369040000)/,593,715,0,0,356,415,0,2022-01-28 06:24:00
4301.5,301,317,4302.5,4297.25,4298.75,13,/Date(1643369100000)/,750,847,0,0,449,530,0,2022-01-28 06:25:00
4302.25,210,249,4302.5,4299.75,4301.5,13,/Date(1643369160000)/,476,566,0,0,266,317,0,2022-01-28 06:26:00
4299.75,250,267,4302.5,4299.25,4302.25,13,/Date(1643369220000)/,377,450,0,0,127,183,0,2022-01-28 06:27:00
4302.25,140,162,4303.0,4299.0,4299.25,13,/Date(1643369280000)/,306,350,0,0,166,188,0,2022-01-28 06:28:00
4303.5,280,340,4305.5,4301.5,4302.5,13,/Date(1643369340000)/,594,855,0,0,314,515,0,2022-01-28 06:29:00
4304.5,139,154,4305.25,4303.5,4303.75,13,/Date(1643369400000)/,284,320,0,0,145,166,0,2022-01-28 06:30:00
4306.0,301,347,4307.0,4304.25,4304.5,13,/Date(1643369460000)/,569,678,0,0,268,331,0,2022-01-28 06:31:00
4303.25,338,407,4307.5,4302.75,4306.0,13,/Date(1643369520000)/,638,754,0,0,300,347,0,2022-01-28 06:32:00
4304.25,132,142,4304.25,4302.75,4303.5,13,/Date(1643369580000)/,245,285,0,0,113,143,0,2022-01-28 06:33:00
4303.0,155,203,4304.75,4302.25,4304.25,13,/Date(1643369640000)/,270,332,0,0,115,129,0,2022-01-28 06:34:00
4306.0,121,131,4306.0,4303.0,4303.0,13,/Date(1643369700000)/,330,423,0,0,209,292,0,2022-01-28 06:35:00
4306.75,179,274,4307.5,4306.0,4306.0,13,/Date(1643369760000)/,423,545,0,0,244,271,0,2022-01-28 06:36:00
4308.0,322,430,4308.75,4304.75,4306.75,13,/Date(1643369820000)/,628,806,0,0,306,376,0,2022-01-28 06:37:00
4305.5,194,217,4308.0,4305.25,4307.75,13,/Date(1643369880000)/,281,321,0,0,87,104,0,2022-01-28 06:38:00
4303.5,246,348,4305.75,4303.0,4305.5,13,/Date(1643369940000)/,391,508,0,0,145,160,0,2022-01-28 06:39:00
4302.0,345,413,4303.75,4301.0,4303.5,13,/Date(1643370000000)/,562,662,0,0,217,249,0,2022-01-28 06:40:00
4298.25,284,345,4302.5,4298.0,4302.0,13,/Date(1643370060000)/,432,509,0,0,148,164,0,2022-01-28 06:41:00
4299.75,119,162,4300.5,4298.25,4298.25,13,/Date(1643370120000)/,278,332,0,0,159,170,0,2022-01-28 06:42:00
4300.5,99,102,4301.0,4299.0,4299.75,13,/Date(1643370180000)/,215,225,0,0,116,123,0,2022-01-28 06:43:00
4301.25,166,259,4301.75,4299.25,4300.25,13,/Date(1643370240000)/,275,378,0,0,109,119,0,2022-01-28 06:44:00
4297.0,241,319,4301.5,4296.75,4301.5,13,/Date(1643370300000)/,328,428,0,0,87,109,0,2022-01-28 06:45:00
4296.5,289,401,4297.75,4294.5,4297.0,13,/Date(1643370360000)/,535,722,0,0,246,321,0,2022-01-28 06:46:00
4298.0,131,161,4298.25,4296.75,4296.75,13,/Date(1643370420000)/,277,341,0,0,146,180,0,2022-01-28 06:47:00
4301.0,150,162,4301.5,4298.25,4298.25,13,/Date(1643370480000)/,455,682,0,0,305,520,0,2022-01-28 06:48:00
4302.75,233,302,4303.5,4301.0,4301.0,13,/Date(1643370540000)/,514,662,0,0,281,360,0,2022-01-28 06:49:00
4302.0,102,113,4302.75,4301.25,4302.5,13,/Date(1643370600000)/,215,229,0,0,113,116,0,2022-01-28 06:50:00
4301.25,109,114,4303.75,4300.75,4302.25,13,/Date(1643370660000)/,215,225,0,0,106,111,0,2022-01-28 06:51:00
4300.25,174,239,4301.75,4299.0,4301.25,13,/Date(1643370720000)/,325,460,0,0,151,221,0,2022-01-28 06:52:00
4297.5,107,140,4300.25,4297.5,4300.25,13,/Date(1643370780000)/,173,224,0,0,66,84,0,2022-01-28 06:53:00
4295.5,184,228,4297.5,4295.25,4297.5,13,/Date(1643370840000)/,287,348,0,0,103,120,0,2022-01-28 06:54:00
4297.5,124,144,4298.25,4295.5,4295.5,13,/Date(1643370900000)/,308,382,0,0,184,238,0,2022-01-28 06:55:00
4294.75,352,443,4298.0,4294.25,4298.0,13,/Date(1643370960000)/,522,678,0,0,170,235,0,2022-01-28 06:56:00
4296.75,126,138,4298.0,4294.75,4295.0,13,/Date(1643371020000)/,302,350,0,0,176,212,0,2022-01-28 06:57:00
4299.5,85,94,4299.75,4294.75,4296.5,13,/Date(1643371080000)/,245,268,0,0,160,174,0,2022-01-28 06:58:00
4303.0,209,241,4303.25,4299.0,4299.25,13,/Date(1643371140000)/,521,693,0,0,312,452,0,2022-01-28 06:59:00
4304.0,235,290,4304.5,4301.25,4303.25,13,/Date(1643371200000)/,538,652,0,0,303,362,0,2022-01-28 07:00:00
4303.75,287,372,4304.5,4302.75,4303.75,13,/Date(1643371260000)/,591,804,0,0,304,432,0,2022-01-28 07:01:00
4299.75,285,318,4303.75,4299.5,4303.75,13,/Date(1643371320000)/,450,493,0,0,165,175,0,2022-01-28 07:02:00
4302.0,208,242,4302.25,4298.25,4299.75,13,/Date(1643371380000)/,443,548,0,0,235,306,0,2022-01-28 07:03:00
4307.75,222,257,4308.0,4301.5,4302.0,13,/Date(1643371440000)/,592,688,0,0,370,431,0,2022-01-28 07:04:00
4306.5,257,294,4307.75,4305.75,4307.75,13,/Date(1643371500000)/,435,502,0,0,178,208,0,2022-01-28 07:05:00
4306.5,244,280,4307.0,4304.5,4306.25,13,/Date(1643371560000)/,451,575,0,0,207,295,0,2022-01-28 07:06:00
4305.0,172,187,4307.0,4303.75,4306.5,13,/Date(1643371620000)/,295,326,0,0,123,139,0,2022-01-28 07:07:00
4302.75,223,254,4306.0,4302.5,4305.0,13,/Date(1643371680000)/,316,351,0,0,93,97,0,2022-01-28 07:08:00
4303.0,101,125,4303.5,4302.0,4302.75,13,/Date(1643371740000)/,193,222,0,0,92,97,0,2022-01-28 07:09:00
4300.25,137,166,4302.75,4300.0,4302.5,13,/Date(1643371800000)/,216,274,0,0,79,108,0,2022-01-28 07:10:00
4301.0,109,128,4301.0,4299.5,4300.5,13,/Date(1643371860000)/,278,340,0,0,169,212,0,2022-01-28 07:11:00
4298.5,220,251,4300.75,4297.25,4300.75,13,/Date(1643371920000)/,330,363,0,0,110,112,0,2022-01-28 07:12:00
4302.75,84,90,4302.75,4298.75,4298.75,13,/Date(1643371980000)/,268,329,0,0,184,239,0,2022-01-28 07:13:00
4303.5,81,83,4305.25,4302.75,4303.0,13,/Date(1643372040000)/,208,241,0,0,127,158,0,2022-01-28 07:14:00
4302.25,106,125,4303.25,4302.0,4303.25,13,/Date(1643372100000)/,173,196,0,0,67,71,0,2022-01-28 07:15:00
4303.5,103,112,4304.0,4300.75,4302.0,13,/Date(1643372160000)/,241,261,0,0,138,149,0,2022-01-28 07:16:00
4302.5,133,155,4303.75,4302.25,4303.5,13,/Date(1643372220000)/,235,279,0,0,102,124,0,2022-01-28 07:17:00
4299.5,300,357,4302.25,4298.75,4302.25,13,/Date(1643372280000)/,561,912,0,0,261,555,0,2022-01-28 07:18:00
4300.25,224,376,4300.75,4299.0,4299.25,13,/Date(1643372340000)/,558,767,0,0,334,391,0,2022-01-28 07:19:00
4298.0,511,733,4301.25,4295.75,4300.25,13,/Date(1643372400000)/,872,1174,0,0,361,441,0,2022-01-28 07:20:00
4298.75,131,183,4299.75,4298.0,4298.0,13,/Date(1643372460000)/,305,366,0,0,174,183,0,2022-01-28 07:21:00
4294.75,242,296,4299.25,4294.25,4298.75,13,/Date(1643372520000)/,399,460,0,0,157,164,0,2022-01-28 07:22:00
4288.0,1288,1922,4294.5,4286.25,4294.5,13,/Date(1643372580000)/,2301,3160,0,0,1013,1238,0,2022-01-28 07:23:00
4284.0,917,1250,4288.0,4283.0,4287.75,13,/Date(1643372640000)/,1622,2139,0,0,705,889,0,2022-01-28 07:24:00
4283.5,474,652,4287.0,4282.5,4284.25,13,/Date(1643372700000)/,1081,1447,0,0,607,795,0,2022-01-28 07:25:00
4279.0,881,1375,4284.5,4278.5,4283.5,13,/Date(1643372760000)/,1688,2370,0,0,807,995,0,2022-01-28 07:26:00
4282.25,382,494,4283.0,4278.0,4278.5,13,/Date(1643372820000)/,1006,1296,0,0,624,802,0,2022-01-28 07:27:00
4285.5,229,296,4286.0,4282.0,4282.5,13,/Date(1643372880000)/,559,728,0,0,330,432,0,2022-01-28 07:28:00
4287.0,429,479,4288.25,4284.5,4285.25,13,/Date(1643372940000)/,1046,1281,0,0,617,802,0,2022-01-28 07:29:00
4285.25,473,509,4287.25,4283.0,4286.75,13,/Date(1643373000000)/,925,1076,0,0,452,567,0,2022-01-28 07:30:00
4285.75,309,383,4288.25,4284.25,4285.5,13,/Date(1643373060000)/,648,793,0,0,339,410,0,2022-01-28 07:31:00
4286.75,449,583,4288.25,4282.75,4285.5,13,/Date(1643373120000)/,976,1232,0,0,527,649,0,2022-01-28 07:32:00
4289.0,167,187,4289.0,4285.25,4286.5,13,/Date(1643373180000)/,393,471,0,0,226,284,0,2022-01-28 07:33:00
4287.0,279,365,4289.25,4285.75,4288.75,13,/Date(1643373240000)/,492,642,0,0,213,277,0,2022-01-28 07:34:00
4285.0,112,131,4287.0,4284.75,4287.0,13,/Date(1643373300000)/,260,336,0,0,148,205,0,2022-01-28 07:35:00
4283.75,200,231,4286.75,4283.75,4285.25,13,/Date(1643373360000)/,383,471,0,0,183,240,0,2022-01-28 07:36:00
4284.0,298,371,4285.75,4282.5,4284.0,13,/Date(1643373420000)/,561,731,0,0,263,360,0,2022-01-28 07:37:00
4279.5,518,718,4284.25,4278.5,4284.25,13,/Date(1643373480000)/,897,1235,0,0,379,517,0,2022-01-28 07:38:00
4276.75,429,567,4280.5,4276.75,4279.75,13,/Date(1643373540000)/,733,973,0,0,304,406,0,2022-01-28 07:39:00
4275.75,346,407,4277.75,4275.25,4277.0,13,/Date(1643373600000)/,662,825,0,0,316,418,0,2022-01-28 07:40:00
4278.25,720,1064,4278.25,4274.0,4275.75,13,/Date(1643373660000)/,1666,2295,0,0,946,1231,0,2022-01-28 07:41:00
4276.0,413,485,4278.25,4275.0,4278.25,13,/Date(1643373720000)/,720,916,0,0,307,431,0,2022-01-28 07:42:00
4276.5,155,173,4278.5,4276.25,4276.25,13,/Date(1643373780000)/,443,571,0,0,288,398,0,2022-01-28 07:43:00
4273.25,390,616,4277.0,4272.5,4276.5,13,/Date(1643373840000)/,693,1054,0,0,303,438,0,2022-01-28 07:44:00
4272.5,343,427,4274.0,4271.75,4273.0,13,/Date(1643373900000)/,785,1070,0,0,442,643,0,2022-01-28 07:45:00
4273.25,340,544,4274.0,4271.0,4272.5,13,/Date(1643373960000)/,859,1429,0,0,519,885,0,2022-01-28 07:46:00
4269.75,475,799,4273.25,4269.5,4273.25,13,/Date(1643374020000)/,711,1173,0,0,236,374,0,2022-01-28 07:47:00
4269.0,1208,1904,4271.5,4266.25,4270.0,13,/Date(1643374080000)/,2237,3374,0,0,1029,1470,0,2022-01-28 07:48:00
4271.75,888,1407,4272.75,4268.75,4269.25,13,/Date(1643374140000)/,1668,2519,0,0,780,1112,0,2022-01-28 07:49:00
4269.25,431,684,4272.0,4269.0,4271.75,13,/Date(1643374200000)/,811,1317,0,0,380,633,0,2022-01-28 07:50:00
4270.25,410,657,4271.0,4267.75,4269.5,13,/Date(1643374260000)/,977,1415,0,0,567,758,0,2022-01-28 07:51:00
4273.0,213,298,4273.25,4269.5,4270.0,13,/Date(1643374320000)/,595,753,0,0,382,455,0,2022-01-28 07:52:00
4270.5,376,477,4273.25,4270.0,4273.25,13,/Date(1643374380000)/,656,916,0,0,280,439,0,2022-01-28 07:53:00
4275.5,346,426,4276.0,4269.25,4270.25,13,/Date(1643374440000)/,958,1308,0,0,612,882,0,2022-01-28 07:54:00
4275.5,332,440,4276.25,4274.25,4275.5,13,/Date(1643374500000)/,613,824,0,0,281,384,0,2022-01-28 07:55:00
4273.0,679,958,4275.25,4270.25,4275.25,13,/Date(1643374560000)/,1072,1459,0,0,393,501,0,2022-01-28 07:56:00
4276.25,436,510,4277.25,4272.75,4273.25,13,/Date(1643374620000)/,989,1203,0,0,553,693,0,2022-01-28 07:57:00
4275.75,537,764,4278.75,4274.25,4276.25,13,/Date(1643374680000)/,1080,1537,0,0,543,773,0,2022-01-28 07:58:00
4277.25,245,274,4278.0,4275.75,4275.75,13,/Date(1643374740000)/,562,741,0,0,317,467,0,2022-01-28 07:59:00
4277.5,112,116,4278.25,4276.75,4277.0,13,/Date(1643374800000)/,271,301,0,0,159,185,0,2022-01-28 08:00:00
4275.75,452,518,4279.75,4275.5,4277.75,13,/Date(1643374860000)/,820,976,0,0,368,458,0,2022-01-28 08:01:00
4278.25,319,337,4278.75,4273.75,4275.75,13,/Date(1643374920000)/,786,913,0,0,467,576,0,2022-01-28 08:02:00
4277.5,229,297,4279.0,4277.0,4278.0,13,/Date(1643374980000)/,418,549,0,0,189,252,0,2022-01-28 08:03:00
4280.5,414,503,4281.25,4277.5,4277.5,13,/Date(1643375040000)/,1093,1411,0,0,679,908,0,2022-01-28 08:04:00
4282.75,332,443,4282.75,4279.25,4280.25,13,/Date(1643375100000)/,849,1063,0,0,517,620,0,2022-01-28 08:05:00
4279.0,529,686,4283.25,4278.75,4282.5,13,/Date(1643375160000)/,903,1165,0,0,374,479,0,2022-01-28 08:06:00
4279.25,457,536,4280.5,4277.75,4278.75,13,/Date(1643375220000)/,829,974,0,0,372,438,0,2022-01-28 08:07:00
4275.75,608,749,4279.25,4274.0,4278.75,13,/Date(1643375280000)/,1044,1295,0,0,436,546,0,2022-01-28 08:08:00
4275.5,356,426,4277.75,4273.5,4276.0,13,/Date(1643375340000)/,693,827,0,0,337,401,0,2022-01-28 08:09:00
4276.5,523,648,4278.75,4275.5,4275.75,13,/Date(1643375400000)/,1005,1245,0,0,482,597,0,2022-01-28 08:10:00
4277.0,319,360,4277.5,4274.75,4276.25,13,/Date(1643375460000)/,626,742,0,0,307,382,0,2022-01-28 08:11:00
4282.0,536,789,4283.0,4276.75,4277.0,13,/Date(1643375520000)/,1322,1820,0,0,786,1031,0,2022-01-28 08:12:00
4278.0,469,579,4282.25,4277.25,4282.25,13,/Date(1643375580000)/,772,962,0,0,303,383,0,2022-01-28 08:13:00
4280.0,344,532,4280.25,4276.0,4277.75,13,/Date(1643375640000)/,796,1063,0,0,452,531,0,2022-01-28 08:14:00
4282.0,299,410,4283.0,4279.0,4280.0,13,/Date(1643375700000)/,768,943,0,0,469,533,0,2022-01-28 08:15:00
4285.25,575,675,4286.75,4282.0,4282.25,13,/Date(1643375760000)/,1394,1745,0,0,819,1070,0,2022-01-28 08:16:00
4287.25,640,865,4288.75,4283.25,4285.0,13,/Date(1643375820000)/,1370,1819,0,0,730,954,0,2022-01-28 08:17:00
4285.25,444,517,4288.25,4284.0,4287.5,13,/Date(1643375880000)/,880,1044,0,0,436,527,0,2022-01-28 08:18:00
4284.5,576,771,4285.25,4283.0,4285.25,13,/Date(1643375940000)/,1007,1443,0,0,431,672,0,2022-01-28 08:19:00
4285.5,403,561,4286.5,4283.75,4284.5,13,/Date(1643376000000)/,883,1273,0,0,480,712,0,2022-01-28 08:20:00
4281.5,548,636,4286.0,4281.0,4285.5,13,/Date(1643376060000)/,862,1031,0,0,314,395,0,2022-01-28 08:21:00
4282.0,421,759,4282.75,4280.75,4281.75,13,/Date(1643376120000)/,942,1484,0,0,521,725,0,2022-01-28 08:22:00
4279.5,549,630,4283.0,4279.0,4282.25,13,/Date(1643376180000)/,917,1201,0,0,368,571,0,2022-01-28 08:23:00
4280.75,308,400,4281.5,4279.0,4279.75,13,/Date(1643376240000)/,696,941,0,0,388,541,0,2022-01-28 08:24:00
4280.5,267,384,4282.5,4280.25,4280.75,13,/Date(1643376300000)/,597,834,0,0,330,450,0,2022-01-28 08:25:00
4276.5,491,680,4281.25,4276.0,4280.75,13,/Date(1643376360000)/,874,1225,0,0,383,545,0,2022-01-28 08:26:00
4277.25,247,395,4278.75,4275.75,4277.0,13,/Date(1643376420000)/,547,781,0,0,300,386,0,2022-01-28 08:27:00
4281.25,295,433,4282.75,4276.25,4277.25,13,/Date(1643376480000)/,832,1209,0,0,537,776,0,2022-01-28 08:28:00
4278.75,237,334,4281.75,4276.5,4281.0,13,/Date(1643376540000)/,410,543,0,0,173,209,0,2022-01-28 08:29:00
4280.25,149,255,4280.5,4278.5,4278.75,13,/Date(1643376600000)/,263,535,0,0,114,280,0,2022-01-28 08:30:00
4295.75,2059,2884,4298.0,4280.0,4280.0,13,/Date(1643376660000)/,4984,6905,0,0,2925,4021,0,2022-01-28 08:31:00
4304.25,3004,4792,4311.25,4295.0,4295.75,13,/Date(1643376720000)/,6200,9992,0,0,3196,5200,0,2022-01-28 08:32:00
4307.75,2208,3067,4313.25,4303.25,4304.5,13,/Date(1643376780000)/,4738,6839,0,0,2530,3772,0,2022-01-28 08:33:00
4309.0,1052,1304,4309.0,4304.25,4307.75,13,/Date(1643376840000)/,2106,2690,0,0,1054,1386,0,2022-01-28 08:34:00
4306.75,860,1079,4310.5,4304.5,4308.75,13,/Date(1643376900000)/,1637,2186,0,0,777,1107,0,2022-01-28 08:35:00
4305.5,755,1085,4309.75,4304.75,4306.75,13,/Date(1643376960000)/,1554,2073,0,0,799,988,0,2022-01-28 08:36:00
4306.5,943,1201,4311.75,4303.25,4305.75,13,/Date(1643377020000)/,1994,2508,0,0,1051,1307,0,2022-01-28 08:37:00
4309.25,669,764,4311.5,4305.75,4306.5,13,/Date(1643377080000)/,1503,1866,0,0,834,1102,0,2022-01-28 08:38:00
4315.5,910,1158,4315.75,4306.75,4309.5,13,/Date(1643377140000)/,2157,3093,0,0,1247,1935,0,2022-01-28 08:39:00
4314.25,821,1175,4315.5,4312.0,4315.5,13,/Date(1643377200000)/,1715,2338,0,0,894,1163,0,2022-01-28 08:40:00
4312.0,973,1328,4315.75,4309.25,4314.25,13,/Date(1643377260000)/,1747,2331,0,0,774,1003,0,2022-01-28 08:41:00
4318.0,732,1005,4318.5,4311.75,4312.0,13,/Date(1643377320000)/,1950,2986,0,0,1218,1981,0,2022-01-28 08:42:00
4317.5,1125,1506,4322.25,4316.5,4318.25,13,/Date(1643377380000)/,2293,3230,0,0,1168,1724,0,2022-01-28 08:43:00
4320.25,422,509,4320.25,4315.5,4317.5,13,/Date(1643377440000)/,972,1197,0,0,550,688,0,2022-01-28 08:44:00
4315.75,565,781,4321.0,4315.75,4320.25,13,/Date(1643377500000)/,963,1348,0,0,398,567,0,2022-01-28 08:45:00
4311.5,949,1165,4317.5,4311.0,4316.0,13,/Date(1643377560000)/,1640,1983,0,0,691,818,0,2022-01-28 08:46:00
4313.0,646,979,4313.0,4309.25,4311.5,13,/Date(1643377620000)/,1329,1950,0,0,683,971,0,2022-01-28 08:47:00
4312.0,475,653,4313.5,4310.75,4312.75,13,/Date(1643377680000)/,932,1215,0,0,457,562,0,2022-01-28 08:48:00
4311.5,439,565,4312.75,4310.0,4312.0,13,/Date(1643377740000)/,809,1025,0,0,370,460,0,2022-01-28 08:49:00
4307.75,806,1289,4312.25,4307.5,4311.25,13,/Date(1643377800000)/,1227,1916,0,0,421,627,0,2022-01-28 08:50:00
4305.5,859,1503,4309.75,4304.25,4307.5,13,/Date(1643377860000)/,1653,2449,0,0,794,946,0,2022-01-28 08:51:00
4308.25,512,729,4309.5,4303.5,4305.75,13,/Date(1643377920000)/,1198,1631,0,0,686,902,0,2022-01-28 08:52:00
4303.25,818,1050,4310.0,4303.0,4308.0,13,/Date(1643377980000)/,1332,1769,0,0,514,719,0,2022-01-28 08:53:00
4304.75,561,734,4305.0,4302.0,4303.5,13,/Date(1643378040000)/,1109,1512,0,0,548,778,0,2022-01-28 08:54:00
4305.75,484,578,4307.0,4303.75,4304.75,13,/Date(1643378100000)/,963,1200,0,0,479,622,0,2022-01-28 08:55:00
4303.75,302,372,4306.0,4303.25,4306.0,13,/Date(1643378160000)/,598,745,0,0,296,373,0,2022-01-28 08:56:00
4307.0,263,304,4307.5,4303.5,4303.5,13,/Date(1643378220000)/,634,779,0,0,371,475,0,2022-01-28 08:57:00
4312.0,594,895,4313.5,4306.75,4306.75,13,/Date(1643378280000)/,1408,2073,0,0,814,1178,0,2022-01-28 08:58:00
4314.0,322,373,4314.5,4312.0,4312.0,13,/Date(1643378340000)/,642,792,0,0,320,419,0,2022-01-28 08:59:00
4313.75,323,375,4314.5,4311.75,4314.0,13,/Date(1643378400000)/,635,864,0,0,312,489,0,2022-01-28 09:00:00
4310.75,571,717,4315.0,4310.25,4313.75,13,/Date(1643378460000)/,922,1121,0,0,351,404,0,2022-01-28 09:01:00
4309.75,353,435,4311.0,4308.0,4311.0,13,/Date(1643378520000)/,600,730,0,0,247,295,0,2022-01-28 09:02:00
4305.5,554,733,4310.5,4305.0,4309.5,13,/Date(1643378580000)/,881,1111,0,0,327,378,0,2022-01-28 09:03:00
4307.25,459,620,4307.75,4303.5,4305.25,13,/Date(1643378640000)/,1048,1424,0,0,589,804,0,2022-01-28 09:04:00
4315.75,666,892,4316.0,4307.25,4307.25,13,/Date(1643378700000)/,1770,2544,0,0,1104,1652,0,2022-01-28 09:05:00
4313.25,807,1148,4317.25,4312.0,4316.0,13,/Date(1643378760000)/,1444,1954,0,0,637,806,0,2022-01-28 09:06:00
4314.75,393,469,4316.0,4313.0,4313.5,13,/Date(1643378820000)/,712,868,0,0,319,399,0,2022-01-28 09:07:00
4314.5,475,595,4317.5,4312.5,4314.75,13,/Date(1643378880000)/,939,1197,0,0,464,602,0,2022-01-28 09:08:00
4320.25,497,664,4321.0,4314.0,4314.25,13,/Date(1643378940000)/,1154,1655,0,0,657,991,0,2022-01-28 09:09:00
4319.5,624,857,4320.75,4318.75,4320.25,13,/Date(1643379000000)/,1256,1748,0,0,632,891,0,2022-01-28 09:10:00
4317.0,673,779,4320.5,4315.25,4319.5,13,/Date(1643379060000)/,1185,1400,0,0,512,621,0,2022-01-28 09:11:00
4315.25,373,506,4317.75,4315.25,4316.75,13,/Date(1643379120000)/,650,854,0,0,277,348,0,2022-01-28 09:12:00
4317.5,342,431,4318.25,4313.25,4315.25,13,/Date(1643379180000)/,765,996,0,0,423,565,0,2022-01-28 09:13:00
4315.0,300,351,4317.5,4314.0,4317.5,13,/Date(1643379240000)/,409,501,0,0,109,150,0,2022-01-28 09:14:00
4314.5,282,358,4316.0,4313.25,4315.0,13,/Date(1643379300000)/,548,728,0,0,266,370,0,2022-01-28 09:15:00
4315.0,248,309,4315.5,4313.5,4314.5,13,/Date(1643379360000)/,462,583,0,0,214,274,0,2022-01-28 09:16:00
4318.5,292,367,4319.0,4314.5,4315.0,13,/Date(1643379420000)/,687,893,0,0,395,526,0,2022-01-28 09:17:00
4320.5,357,474,4321.5,4317.5,4318.25,13,/Date(1643379480000)/,800,1068,0,0,443,594,0,2022-01-28 09:18:00
4319.0,412,583,4321.25,4318.25,4321.0,13,/Date(1643379540000)/,805,1074,0,0,393,491,0,2022-01-28 09:19:00
4321.5,227,280,4321.75,4318.75,4319.0,13,/Date(1643379600000)/,563,690,0,0,336,410,0,2022-01-28 09:20:00
4324.25,443,572,4324.25,4321.5,4321.5,13,/Date(1643379660000)/,1133,1509,0,0,690,937,0,2022-01-28 09:21:00
4325.0,490,632,4325.5,4323.0,4324.0,13,/Date(1643379720000)/,1031,1397,0,0,541,765,0,2022-01-28 09:22:00
4326.5,393,508,4326.75,4324.25,4325.0,13,/Date(1643379780000)/,819,1105,0,0,426,597,0,2022-01-28 09:23:00
4323.25,610,812,4326.5,4323.25,4326.5,13,/Date(1643379840000)/,943,1215,0,0,333,403,0,2022-01-28 09:24:00
4323.25,480,585,4324.5,4321.5,4323.25,13,/Date(1643379900000)/,808,1031,0,0,328,446,0,2022-01-28 09:25:00
4326.5,434,565,4327.0,4323.5,4323.5,13,/Date(1643379960000)/,917,1309,0,0,483,744,0,2022-01-28 09:26:00
4326.25,382,511,4327.0,4325.0,4326.25,13,/Date(1643380020000)/,794,1052,0,0,412,541,0,2022-01-28 09:27:00
4325.0,557,670,4326.75,4323.5,4326.5,13,/Date(1643380080000)/,954,1139,0,0,397,469,0,2022-01-28 09:28:00
4327.0,710,929,4328.75,4324.0,4325.0,13,/Date(1643380140000)/,1277,1834,0,0,567,905,0,2022-01-28 09:29:00
4332.0,1114,1641,4332.75,4326.75,4327.0,13,/Date(1643380200000)/,2479,3780,0,0,1365,2139,0,2022-01-28 09:30:00
4335.5,4526,5758,4336.5,4329.25,4332.0,13,/Date(1643380260000)/,8714,11759,0,0,4188,6001,0,2022-01-28 09:31:00
4323.25,3905,4692,4335.75,4322.25,4335.5,13,/Date(1643380320000)/,6801,8150,0,0,2896,3458,0,2022-01-28 09:32:00
4312.75,3981,5610,4323.75,4311.5,4323.5,13,/Date(1643380380000)/,7415,10022,0,0,3434,4412,0,2022-01-28 09:33:00
4307.25,2816,3678,4316.0,4306.25,4312.75,13,/Date(1643380440000)/,5208,6686,0,0,2392,3008,0,2022-01-28 09:34:00
4303.75,2676,3457,4310.75,4303.0,4307.25,13,/Date(1643380500000)/,5377,6846,0,0,2701,3389,0,2022-01-28 09:35:00
4292.75,4108,5987,4306.5,4291.0,4303.75,13,/Date(1643380560000)/,7567,10716,0,0,3459,4729,0,2022-01-28 09:36:00
4291.25,2828,3974,4299.75,4289.75,4292.75,13,/Date(1643380620000)/,6059,8435,0,0,3231,4461,0,2022-01-28 09:37:00
4295.5,2366,2918,4299.75,4290.25,4291.0,13,/Date(1643380680000)/,5065,6399,0,0,2699,3481,0,2022-01-28 09:38:00
4295.25,1813,2265,4297.25,4291.25,4295.25,13,/Date(1643380740000)/,3684,4562,0,0,1871,2297,0,2022-01-28 09:39:00
4294.75,2253,3051,4297.75,4291.5,4295.25,13,/Date(1643380800000)/,4566,5907,0,0,2313,2856,0,2022-01-28 09:40:00
4296.75,2454,3022,4299.25,4291.25,4294.75,13,/Date(1643380860000)/,4742,5917,0,0,2288,2895,0,2022-01-28 09:41:00
4296.25,2552,3537,4299.0,4290.5,4297.0,13,/Date(1643380920000)/,5407,7184,0,0,2855,3647,0,2022-01-28 09:42:00
4293.75,1938,2570,4296.75,4290.0,4296.0,13,/Date(1643380980000)/,3748,5086,0,0,1810,2516,0,2022-01-28 09:43:00
4295.0,2113,2576,4298.5,4292.5,4294.0,13,/Date(1643381040000)/,4381,5526,0,0,2268,2950,0,2022-01-28 09:44:00
4291.25,2380,3087,4296.0,4290.25,4295.0,13,/Date(1643381100000)/,4478,5901,0,0,2098,2814,0,2022-01-28 09:45:00
4289.25,4140,5842,4294.5,4286.0,4291.5,13,/Date(1643381160000)/,7587,10018,0,0,3447,4176,0,2022-01-28 09:46:00
4286.75,2849,3413,4293.5,4286.5,4289.25,13,/Date(1643381220000)/,5606,6997,0,0,2757,3584,0,2022-01-28 09:47:00
4286.0,2431,3143,4288.5,4285.25,4286.75,13,/Date(1643381280000)/,4370,5469,0,0,1939,2326,0,2022-01-28 09:48:00
4290.25,2493,3780,4291.5,4283.5,4285.75,13,/Date(1643381340000)/,5169,7281,0,0,2676,3501,0,2022-01-28 09:49:00
4290.5,3199,4003,4298.5,4290.0,4290.25,13,/Date(1643381400000)/,6084,7838,0,0,2885,3835,0,2022-01-28 09:50:00
4296.25,2397,2796,4296.25,4287.25,4290.5,13,/Date(1643381460000)/,4703,5633,0,0,2306,2837,0,2022-01-28 09:51:00
4300.25,3461,4738,4303.25,4294.75,4296.25,13,/Date(1643381520000)/,7384,10161,0,0,3923,5423,0,2022-01-28 09:52:00
4297.75,2382,2811,4302.75,4296.0,4300.25,13,/Date(1643381580000)/,4197,4934,0,0,1815,2123,0,2022-01-28 09:53:00
4294.0,2363,2784,4302.75,4293.75,4298.0,13,/Date(1643381640000)/,4311,5075,0,0,1948,2291,0,2022-01-28 09:54:00
4292.5,2426,2916,4296.0,4287.75,4294.0,13,/Date(1643381700000)/,4842,5791,0,0,2416,2875,0,2022-01-28 09:55:00
4289.5,2055,2465,4295.0,4288.0,4292.25,13,/Date(1643381760000)/,3593,4325,0,0,1538,1860,0,2022-01-28 09:56:00
4291.75,2642,3813,4294.75,4287.25,4289.5,13,/Date(1643381820000)/,5061,6728,0,0,2419,2915,0,2022-01-28 09:57:00
4293.25,1885,2607,4297.0,4290.75,4291.75,13,/Date(1643381880000)/,3784,4850,0,0,1899,2243,0,2022-01-28 09:58:00
4289.5,1395,1828,4294.5,4288.75,4293.5,13,/Date(1643381940000)/,2684,3488,0,0,1289,1660,0,2022-01-28 09:59:00
4289.75,1861,2886,4290.75,4285.25,4289.75,13,/Date(1643382000000)/,3265,4832,0,0,1404,1946,0,2022-01-28 10:00:00
4287.0,1968,2336,4293.5,4286.5,4289.5,13,/Date(1643382060000)/,3817,4588,0,0,1849,2252,0,2022-01-28 10:01:00
4285.5,2701,3765,4288.75,4283.0,4287.0,13,/Date(1643382120000)/,4964,6469,0,0,2263,2704,0,2022-01-28 10:02:00
4285.5,1440,1937,4288.0,4284.0,4285.5,13,/Date(1643382180000)/,2685,3498,0,0,1245,1561,0,2022-01-28 10:03:00
4289.5,2022,2664,4292.5,4283.75,4285.5,13,/Date(1643382240000)/,4426,5797,0,0,2404,3133,0,2022-01-28 10:04:00
4290.75,1847,2370,4294.25,4289.0,4289.75,13,/Date(1643382300000)/,3682,4786,0,0,1835,2416,0,2022-01-28 10:05:00
4296.0,1550,1829,4297.0,4289.5,4291.0,13,/Date(1643382360000)/,3430,4250,0,0,1880,2421,0,2022-01-28 10:06:00
4292.0,1887,2141,4295.75,4288.25,4295.75,13,/Date(1643382420000)/,3505,4087,0,0,1618,1946,0,2022-01-28 10:07:00
4294.0,1429,1697,4296.0,4290.5,4291.75,13,/Date(1643382480000)/,2934,3481,0,0,1505,1784,0,2022-01-28 10:08:00
4293.75,2395,2814,4301.25,4292.0,4294.0,13,/Date(1643382540000)/,4735,5722,0,0,2340,2908,0,2022-01-28 10:09:00
4298.75,1599,1838,4301.0,4292.5,4293.5,13,/Date(1643382600000)/,3152,3725,0,0,1553,1887,0,2022-01-28 10:10:00
4306.75,2802,3399,4308.5,4298.0,4298.75,13,/Date(1643382660000)/,6148,7574,0,0,3346,4175,0,2022-01-28 10:11:00
4311.5,2240,2777,4312.5,4304.5,4306.75,13,/Date(1643382720000)/,4687,6120,0,0,2447,3343,0,2022-01-28 10:12:00
4310.5,1790,2168,4313.25,4309.75,4311.5,13,/Date(1643382780000)/,3379,4182,0,0,1589,2014,0,2022-01-28 10:13:00
4304.25,2601,3216,4311.25,4303.0,4310.5,13,/Date(1643382840000)/,4561,5752,0,0,1960,2536,0,2022-01-28 10:14:00
4306.75,1354,1619,4307.75,4304.0,4304.0,13,/Date(1643382900000)/,2884,3512,0,0,1530,1893,0,2022-01-28 10:15:00
4314.0,2594,3099,4316.0,4305.25,4306.75,13,/Date(1643382960000)/,5544,6924,0,0,2950,3825,0,2022-01-28 10:16:00
4316.75,2021,2299,4317.0,4310.0,4314.25,13,/Date(1643383020000)/,4334,5472,0,0,2313,3173,0,2022-01-28 10:17:00
4314.25,1762,2166,4317.0,4312.25,4316.5,13,/Date(1643383080000)/,3241,4145,0,0,1479,1979,0,2022-01-28 10:18:00
4320.75,1885,2582,4321.75,4313.5,4314.0,13,/Date(1643383140000)/,4299,6321,0,0,2414,3739,0,2022-01-28 10:19:00
4326.0,2272,2898,4326.75,4320.25,4320.5,13,/Date(1643383200000)/,5065,6964,0,0,2793,4066,0,2022-01-28 10:20:00
4324.0,2467,3135,4326.5,4321.25,4326.25,13,/Date(1643383260000)/,4523,5812,0,0,2056,2677,0,2022-01-28 10:21:00
4325.5,1666,1949,4328.25,4323.5,4323.75,13,/Date(1643383320000)/,3621,4581,0,0,1955,2632,0,2022-01-28 10:22:00
4316.75,2903,3785,4326.5,4315.25,4325.5,13,/Date(1643383380000)/,5133,6551,0,0,2230,2766,0,2022-01-28 10:23:00
4315.25,2522,3184,4318.0,4312.0,4317.0,13,/Date(1643383440000)/,4640,5834,0,0,2118,2650,0,2022-01-28 10:24:00
4315.0,1625,2141,4316.5,4311.25,4315.25,13,/Date(1643383500000)/,3222,4249,0,0,1597,2108,0,2022-01-28 10:25:00
4314.75,1523,1708,4316.75,4313.25,4315.0,13,/Date(1643383560000)/,2850,3332,0,0,1327,1624,0,2022-01-28 10:26:00
4312.25,1658,1939,4318.25,4312.0,4314.75,13,/Date(1643383620000)/,3208,4022,0,0,1550,2083,0,2022-01-28 10:27:00
4311.0,1987,2590,4314.75,4307.75,4312.0,13,/Date(1643383680000)/,3732,4790,0,0,1745,2200,0,2022-01-28 10:28:00
4305.0,2200,2730,4311.25,4304.5,4311.0,13,/Date(1643383740000)/,3753,4781,0,0,1553,2051,0,2022-01-28 10:29:00
4312.0,1343,1600,4312.5,4305.0,4305.0,13,/Date(1643383800000)/,2994,3671,0,0,1651,2071,0,2022-01-28 10:30:00
4312.5,1793,2142,4314.0,4306.25,4312.25,13,/Date(1643383860000)/,3630,4330,0,0,1837,2188,0,2022-01-28 10:31:00
4310.75,1341,1645,4313.5,4308.5,4312.75,13,/Date(1643383920000)/,2740,3249,0,0,1399,1604,0,2022-01-28 10:32:00
4306.5,1510,1769,4312.0,4305.5,4311.0,13,/Date(1643383980000)/,2808,3270,0,0,1298,1501,0,2022-01-28 10:33:00
4302.75,1940,2504,4306.5,4299.25,4306.25,13,/Date(1643384040000)/,3830,4748,0,0,1890,2244,0,2022-01-28 10:34:00
4300.25,1539,1904,4303.25,4298.25,4302.75,13,/Date(1643384100000)/,3096,3804,0,0,1557,1900,0,2022-01-28 10:35:00
4302.25,1487,1789,4303.75,4299.75,4300.5,13,/Date(1643384160000)/,3216,4106,0,0,1729,2317,0,2022-01-28 10:36:00
4305.75,1615,1970,4309.0,4301.25,4302.25,13,/Date(1643384220000)/,3430,4345,0,0,1815,2375,0,2022-01-28 10:37:00
4312.75,2091,2463,4316.5,4305.75,4305.75,13,/Date(1643384280000)/,4224,5145,0,0,2133,2682,0,2022-01-28 10:38:00
4315.0,1604,2054,4318.75,4312.0,4312.5,13,/Date(1643384340000)/,3053,3827,0,0,1449,1773,0,2022-01-28 10:39:00
4310.75,1638,1944,4315.75,4308.5,4315.0,13,/Date(1643384400000)/,3051,3562,0,0,1413,1618,0,2022-01-28 10:40:00
4307.25,1519,1796,4311.25,4305.75,4310.75,13,/Date(1643384460000)/,2881,3359,0,0,1362,1563,0,2022-01-28 10:41:00
4306.0,1581,1923,4311.0,4303.5,4307.5,13,/Date(1643384520000)/,3041,3699,0,0,1460,1776,0,2022-01-28 10:42:00
4297.5,2940,3731,4306.5,4295.25,4305.75,13,/Date(1643384580000)/,5342,6779,0,0,2402,3048,0,2022-01-28 10:43:00
4298.5,1550,2180,4299.75,4296.75,4297.25,13,/Date(1643384640000)/,3375,4504,0,0,1825,2324,0,2022-01-28 10:44:00
4298.5,1306,1646,4300.25,4296.75,4298.75,13,/Date(1643384700000)/,2586,3137,0,0,1280,1491,0,2022-01-28 10:45:00
4299.75,1654,2089,4302.5,4297.0,4298.5,13,/Date(1643384760000)/,3554,4641,0,0,1900,2552,0,2022-01-28 10:46:00
4305.0,1650,2087,4307.75,4299.5,4299.75,13,/Date(1643384820000)/,3246,4189,0,0,1596,2102,0,2022-01-28 10:47:00
4316.75,2192,2699,4318.75,4304.75,4304.75,13,/Date(1643384880000)/,4897,6546,0,0,2705,3847,0,2022-01-28 10:48:00
4314.0,1424,1775,4317.25,4313.5,4316.5,13,/Date(1643384940000)/,2669,3353,0,0,1245,1578,0,2022-01-28 10:49:00
4324.5,2479,3106,4326.25,4314.0,4314.0,13,/Date(1643385000000)/,5757,7730,0,0,3278,4624,0,2022-01-28 10:50:00
4325.75,1975,2370,4328.25,4324.75,4325.0,13,/Date(1643385060000)/,4033,4865,0,0,2058,2495,0,2022-01-28 10:51:00
4323.5,2072,2494,4326.75,4321.25,4325.75,13,/Date(1643385120000)/,3902,4985,0,0,1830,2491,0,2022-01-28 10:52:00
4325.25,1207,1547,4326.25,4322.0,4323.75,13,/Date(1643385180000)/,2485,3147,0,0,1278,1600,0,2022-01-28 10:53:00
4330.5,1495,1832,4331.25,4324.75,4325.0,13,/Date(1643385240000)/,3571,4895,0,0,2076,3063,0,2022-01-28 10:54:00
4333.75,1762,2268,4334.5,4328.0,4330.5,13,/Date(1643385300000)/,3643,4683,0,0,1881,2415,0,2022-01-28 10:55:00
4330.5,2307,3207,4334.75,4328.25,4334.0,13,/Date(1643385360000)/,4369,6551,0,0,2062,3344,0,2022-01-28 10:56:00
4326.5,1635,1982,4331.0,4324.0,4330.75,13,/Date(1643385420000)/,3042,3701,0,0,1407,1719,0,2022-01-28 10:57:00
4330.75,1635,1982,4333.0,4324.75,4326.75,13,/Date(1643385480000)/,3436,4380,0,0,1801,2398,0,2022-01-28 10:58:00
4332.5,1153,1339,4333.0,4329.25,4331.0,13,/Date(1643385540000)/,2347,2765,0,0,1194,1426,0,2022-01-28 10:59:00
4338.75,2340,3121,4340.0,4330.0,4332.75,13,/Date(1643385600000)/,5240,7203,0,0,2900,4082,0,2022-01-28 11:00:00
4335.75,2341,2846,4341.75,4333.5,4339.0,13,/Date(1643385660000)/,4619,5795,0,0,2278,2949,0,2022-01-28 11:01:00
4332.25,1697,2381,4337.25,4331.75,4335.75,13,/Date(1643385720000)/,3106,4137,0,0,1409,1756,0,2022-01-28 11:02:00
4331.25,1985,2580,4332.5,4327.5,4332.5,13,/Date(1643385780000)/,3667,4837,0,0,1682,2257,0,2022-01-28 11:03:00
4332.75,1486,1847,4337.0,4331.25,4331.25,13,/Date(1643385840000)/,2791,3434,0,0,1305,1587,0,2022-01-28 11:04:00
4328.25,1711,2184,4333.0,4325.5,4333.0,13,/Date(1643385900000)/,2863,3597,0,0,1152,1413,0,2022-01-28 11:05:00
4331.0,1630,1943,4332.75,4328.0,4328.0,13,/Date(1643385960000)/,3394,4042,0,0,1764,2099,0,2022-01-28 11:06:00
4331.5,993,1252,4333.75,4328.5,4331.0,13,/Date(1643386020000)/,1996,2468,0,0,1003,1216,0,2022-01-28 11:07:00
4329.0,1310,1542,4332.5,4328.0,4331.5,13,/Date(1643386080000)/,2464,2986,0,0,1154,1444,0,2022-01-28 11:08:00
4334.25,1139,1439,4336.5,4328.75,4329.0,13,/Date(1643386140000)/,2637,3270,0,0,1498,1831,0,2022-01-28 11:09:00
4336.5,1320,1531,4337.5,4332.75,4334.0,13,/Date(1643386200000)/,2835,3362,0,0,1515,1831,0,2022-01-28 11:10:00
4344.75,2055,2616,4345.0,4334.25,4336.75,13,/Date(1643386260000)/,4277,5930,0,0,2222,3314,0,2022-01-28 11:11:00
4347.25,2314,3057,4348.0,4343.0,4344.75,13,/Date(1643386320000)/,4664,6782,0,0,2350,3725,0,2022-01-28 11:12:00
4346.25,1596,2218,4348.0,4343.5,4347.0,13,/Date(1643386380000)/,3162,4170,0,0,1566,1952,0,2022-01-28 11:13:00
4345.25,1122,1527,4346.5,4344.25,4346.25,13,/Date(1643386440000)/,2240,2965,0,0,1118,1438,0,2022-01-28 11:14:00
4346.25,1008,1286,4346.75,4344.5,4345.25,13,/Date(1643386500000)/,1944,2456,0,0,936,1170,0,2022-01-28 11:15:00
4352.25,1733,2272,4352.5,4346.0,4346.25,13,/Date(1643386560000)/,3819,5745,0,0,2086,3473,0,2022-01-28 11:16:00
4352.75,1588,1987,4353.0,4350.25,4352.25,13,/Date(1643386620000)/,3314,4456,0,0,1726,2469,0,2022-01-28 11:17:00
4355.75,1239,1606,4356.25,4352.5,4352.75,13,/Date(1643386680000)/,2739,3822,0,0,1500,2216,0,2022-01-28 11:18:00
4356.0,1736,2427,4359.0,4355.25,4356.0,13,/Date(1643386740000)/,3719,5566,0,0,1983,3139,0,2022-01-28 11:19:00
4356.5,1247,1674,4358.0,4354.5,4356.0,13,/Date(1643386800000)/,2476,3308,0,0,1229,1634,0,2022-01-28 11:20:00
4355.75,1420,1929,4359.0,4354.5,4356.25,13,/Date(1643386860000)/,2519,3380,0,0,1099,1451,0,2022-01-28 11:21:00
4353.25,1561,2631,4357.75,4353.0,4356.0,13,/Date(1643386920000)/,2715,4052,0,0,1154,1421,0,2022-01-28 11:22:00
4351.25,1622,2597,4354.25,4350.75,4353.25,13,/Date(1643386980000)/,2794,4129,0,0,1172,1532,0,2022-01-28 11:23:00
4353.75,939,1191,4354.75,4351.5,4351.5,13,/Date(1643387040000)/,1923,2385,0,0,984,1194,0,2022-01-28 11:24:00
4354.75,1208,2058,4355.5,4351.75,4353.5,13,/Date(1643387100000)/,2341,3942,0,0,1133,1884,0,2022-01-28 11:25:00
4359.5,1281,1710,4359.75,4353.0,4354.5,13,/Date(1643387160000)/,2778,3587,0,0,1497,1877,0,2022-01-28 11:26:00
4361.75,1541,2192,4362.5,4357.5,4359.25,13,/Date(1643387220000)/,3311,4908,0,0,1770,2716,0,2022-01-28 11:27:00
4359.75,2200,3054,4362.0,4356.25,4361.75,13,/Date(1643387280000)/,3893,5192,0,0,1693,2138,0,2022-01-28 11:28:00
4357.25,1470,2188,4360.0,4357.0,4359.75,13,/Date(1643387340000)/,2778,3879,0,0,1308,1691,0,2022-01-28 11:29:00
4355.25,2140,3315,4358.25,4352.5,4357.5,13,/Date(1643387400000)/,4016,5823,0,0,1876,2508,0,2022-01-28 11:30:00
4350.75,2421,3594,4358.25,4350.75,4355.25,13,/Date(1643387460000)/,4478,6420,0,0,2057,2826,0,2022-01-28 11:31:00
4351.25,2496,3538,4353.0,4347.0,4350.75,13,/Date(1643387520000)/,4935,6900,0,0,2439,3362,0,2022-01-28 11:32:00
4356.25,1782,2721,4356.75,4350.0,4351.5,13,/Date(1643387580000)/,3928,5672,0,0,2146,2951,0,2022-01-28 11:33:00
4354.0,1678,2443,4357.0,4351.0,4356.75,13,/Date(1643387640000)/,3314,4545,0,0,1636,2102,0,2022-01-28 11:34:00
4354.25,1692,2484,4355.0,4350.25,4354.25,13,/Date(1643387700000)/,3540,4815,0,0,1848,2331,0,2022-01-28 11:35:00
4355.5,1690,2416,4358.0,4353.0,4354.25,13,/Date(1643387760000)/,3585,4905,0,0,1895,2489,0,2022-01-28 11:36:00
4363.0,2358,3258,4365.25,4353.75,4355.75,13,/Date(1643387820000)/,5019,7152,0,0,2661,3894,0,2022-01-28 11:37:00
4365.0,1799,2428,4366.0,4359.5,4363.0,13,/Date(1643387880000)/,3623,4865,0,0,1824,2437,0,2022-01-28 11:38:00
4364.5,1426,1974,4366.75,4363.25,4364.75,13,/Date(1643387940000)/,2809,3769,0,0,1383,1795,0,2022-01-28 11:39:00
4359.75,1833,2508,4366.25,4358.25,4365.0,13,/Date(1643388000000)/,3411,4804,0,0,1578,2296,0,2022-01-28 11:40:00
4358.0,1469,2290,4360.5,4356.25,4359.75,13,/Date(1643388060000)/,2639,3779,0,0,1170,1489,0,2022-01-28 11:41:00
4358.75,1095,1625,4360.5,4355.25,4358.0,13,/Date(1643388120000)/,2304,3171,0,0,1209,1546,0,2022-01-28 11:42:00
4361.25,1224,1836,4362.75,4358.5,4359.0,13,/Date(1643388180000)/,2428,3391,0,0,1204,1555,0,2022-01-28 11:43:00
4361.0,1293,1934,4363.0,4359.0,4361.5,13,/Date(1643388240000)/,2574,3639,0,0,1281,1705,0,2022-01-28 11:44:00
4357.75,1447,2039,4361.0,4356.5,4360.75,13,/Date(1643388300000)/,2730,3587,0,0,1283,1548,0,2022-01-28 11:45:00
4358.75,1155,1619,4360.0,4356.5,4357.75,13,/Date(1643388360000)/,2533,3225,0,0,1378,1606,0,2022-01-28 11:46:00
4355.75,1390,2163,4360.0,4355.5,4359.0,13,/Date(1643388420000)/,2756,4337,0,0,1366,2174,0,2022-01-28 11:47:00
4358.5,985,1441,4360.0,4355.5,4356.0,13,/Date(1643388480000)/,2140,2843,0,0,1155,1402,0,2022-01-28 11:48:00
4357.75,1314,1879,4360.0,4357.5,4358.75,13,/Date(1643388540000)/,2427,3398,0,0,1113,1519,0,2022-01-28 11:49:00
4357.0,1069,1610,4359.0,4355.5,4358.0,13,/Date(1643388600000)/,2144,2926,0,0,1075,1316,0,2022-01-28 11:50:00
4359.75,910,1327,4360.0,4356.0,4357.25,13,/Date(1643388660000)/,2404,3445,0,0,1494,2118,0,2022-01-28 11:51:00
4357.75,1671,2287,4360.0,4355.25,4360.0,13,/Date(1643388720000)/,2822,3815,0,0,1151,1528,0,2022-01-28 11:52:00
4359.25,1024,1476,4360.0,4357.0,4358.0,13,/Date(1643388780000)/,1929,2844,0,0,905,1368,0,2022-01-28 11:53:00
4360.0,885,1222,4360.0,4356.25,4359.25,13,/Date(1643388840000)/,1989,2793,0,0,1104,1571,0,2022-01-28 11:54:00
4361.5,1234,1684,4363.0,4359.5,4360.0,13,/Date(1643388900000)/,3394,5184,0,0,2160,3500,0,2022-01-28 11:55:00
4366.25,1194,1634,4366.5,4361.25,4361.75,13,/Date(1643388960000)/,2572,3376,0,0,1378,1742,0,2022-01-28 11:56:00
4370.0,1818,2601,4371.25,4366.0,4366.25,13,/Date(1643389020000)/,3601,5989,0,0,1783,3388,0,2022-01-28 11:57:00
4374.25,1490,2167,4374.75,4369.75,4370.25,13,/Date(1643389080000)/,2941,4344,0,0,1451,2177,0,2022-01-28 11:58:00
4374.5,855,1281,4375.75,4374.0,4374.25,13,/Date(1643389140000)/,1858,2676,0,0,1003,1395,0,2022-01-28 11:59:00
4374.25,860,1156,4375.75,4373.5,4374.75,13,/Date(1643389200000)/,1725,2423,0,0,865,1267,0,2022-01-28 12:00:00
4374.5,1398,1900,4376.5,4372.5,4374.5,13,/Date(1643389260000)/,2630,3419,0,0,1232,1519,0,2022-01-28 12:01:00
4372.75,1291,1803,4375.0,4371.5,4374.75,13,/Date(1643389320000)/,2429,3362,0,0,1138,1559,0,2022-01-28 12:02:00
4371.5,1182,1700,4373.75,4369.75,4373.0,13,/Date(1643389380000)/,2045,2865,0,0,863,1165,0,2022-01-28 12:03:00
4371.5,891,1079,4372.25,4369.5,4371.75,13,/Date(1643389440000)/,1748,2088,0,0,857,1009,0,2022-01-28 12:04:00
4377.5,1332,1685,4378.25,4371.0,4371.75,13,/Date(1643389500000)/,2874,3844,0,0,1542,2159,0,2022-01-28 12:05:00
4380.0,1066,1343,4380.25,4375.75,4377.25,13,/Date(1643389560000)/,2487,3369,0,0,1421,2026,0,2022-01-28 12:06:00
4377.75,1713,2427,4380.5,4375.75,4380.0,13,/Date(1643389620000)/,3129,4538,0,0,1416,2111,0,2022-01-28 12:07:00
4376.25,763,903,4379.25,4376.25,4377.75,13,/Date(1643389680000)/,1489,1892,0,0,726,989,0,2022-01-28 12:08:00
4374.75,759,924,4377.0,4374.0,4376.5,13,/Date(1643389740000)/,1421,1712,0,0,662,788,0,2022-01-28 12:09:00
4378.75,809,1024,4379.0,4374.5,4374.5,13,/Date(1643389800000)/,1825,2271,0,0,1016,1247,0,2022-01-28 12:10:00
4378.25,761,980,4378.75,4375.25,4378.75,13,/Date(1643389860000)/,1440,1844,0,0,679,864,0,2022-01-28 12:11:00
4378.5,630,792,4379.5,4377.25,4378.5,13,/Date(1643389920000)/,1203,1610,0,0,573,818,0,2022-01-28 12:12:00
4369.75,2395,3416,4378.75,4368.5,4378.75,13,/Date(1643389980000)/,4500,6384,0,0,2105,2968,0,2022-01-28 12:13:00
4367.25,1492,1966,4370.75,4366.25,4369.75,13,/Date(1643390040000)/,2824,3692,0,0,1332,1726,0,2022-01-28 12:14:00
4370.5,787,971,4371.25,4367.0,4367.0,13,/Date(1643390100000)/,1918,2374,0,0,1131,1403,0,2022-01-28 12:15:00
4369.75,1244,2331,4371.75,4367.75,4370.5,13,/Date(1643390160000)/,2361,4143,0,0,1117,1812,0,2022-01-28 12:16:00
4371.5,503,723,4372.0,4369.25,4369.75,13,/Date(1643390220000)/,1399,1869,0,0,896,1146,0,2022-01-28 12:17:00
4372.5,879,1361,4373.0,4370.25,4371.75,13,/Date(1643390280000)/,1789,2616,0,0,910,1255,0,2022-01-28 12:18:00
4374.75,693,938,4375.0,4371.5,4372.25,13,/Date(1643390340000)/,1974,2973,0,0,1281,2035,0,2022-01-28 12:19:00
4378.0,1282,1707,4380.0,4374.25,4374.5,13,/Date(1643390400000)/,2907,3830,0,0,1625,2123,0,2022-01-28 12:20:00
4369.25,2081,3060,4378.0,4369.25,4378.0,13,/Date(1643390460000)/,3494,4907,0,0,1413,1847,0,2022-01-28 12:21:00
4367.25,1430,1859,4370.0,4367.0,4369.5,13,/Date(1643390520000)/,2473,3167,0,0,1043,1308,0,2022-01-28 12:22:00
4363.5,1941,2847,4368.25,4363.25,4367.0,13,/Date(1643390580000)/,3172,4436,0,0,1231,1589,0,2022-01-28 12:23:00
4366.0,740,955,4366.75,4363.25,4363.75,13,/Date(1643390640000)/,1531,1977,0,0,791,1022,0,2022-01-28 12:24:00
4365.75,932,1229,4366.25,4362.25,4366.25,13,/Date(1643390700000)/,1747,2234,0,0,815,1005,0,2022-01-28 12:25:00
4360.5,1534,2173,4365.5,4359.25,4365.25,13,/Date(1643390760000)/,2781,3891,0,0,1247,1718,0,2022-01-28 12:26:00
4361.5,845,1143,4362.0,4359.0,4360.5,13,/Date(1643390820000)/,2002,2713,0,0,1157,1570,0,2022-01-28 12:27:00
4362.25,873,1081,4365.0,4361.25,4361.5,13,/Date(1643390880000)/,1762,2162,0,0,889,1081,0,2022-01-28 12:28:00
4360.0,1243,1801,4363.0,4357.75,4362.25,13,/Date(1643390940000)/,2260,3105,0,0,1017,1304,0,2022-01-28 12:29:00
4360.25,571,641,4362.5,4359.75,4360.0,13,/Date(1643391000000)/,1229,1475,0,0,658,834,0,2022-01-28 12:30:00
4360.25,777,983,4363.75,4358.75,4360.5,13,/Date(1643391060000)/,1579,1939,0,0,802,956,0,2022-01-28 12:31:00
4361.25,787,921,4363.5,4359.75,4360.25,13,/Date(1643391120000)/,1673,2021,0,0,886,1100,0,2022-01-28 12:32:00
4359.75,1003,1283,4362.5,4359.0,4361.25,13,/Date(1643391180000)/,2075,3010,0,0,1072,1727,0,2022-01-28 12:33:00
4361.25,1215,1479,4362.25,4357.0,4360.0,13,/Date(1643391240000)/,2626,3273,0,0,1411,1794,0,2022-01-28 12:34:00
4360.75,856,1085,4361.75,4359.0,4361.5,13,/Date(1643391300000)/,1581,1937,0,0,725,852,0,2022-01-28 12:35:00
4355.25,1379,1895,4361.0,4354.75,4360.75,13,/Date(1643391360000)/,2292,3018,0,0,913,1123,0,2022-01-28 12:36:00
4357.5,1073,1374,4358.75,4355.25,4355.25,13,/Date(1643391420000)/,2347,3164,0,0,1274,1790,0,2022-01-28 12:37:00
4364.25,1363,1885,4365.5,4356.75,4357.5,13,/Date(1643391480000)/,2960,3819,0,0,1597,1934,0,2022-01-28 12:38:00
4360.25,1154,1456,4364.25,4359.25,4364.25,13,/Date(1643391540000)/,1905,2304,0,0,751,848,0,2022-01-28 12:39:00
4357.0,990,1277,4362.25,4356.5,4360.25,13,/Date(1643391600000)/,1768,2174,0,0,778,897,0,2022-01-28 12:40:00
4359.75,866,1137,4360.75,4356.0,4357.25,13,/Date(1643391660000)/,1882,2613,0,0,1016,1476,0,2022-01-28 12:41:00
4358.75,558,670,4360.25,4357.5,4359.75,13,/Date(1643391720000)/,1193,1398,0,0,635,728,0,2022-01-28 12:42:00
4359.75,925,1204,4361.75,4357.25,4358.75,13,/Date(1643391780000)/,2030,2519,0,0,1105,1315,0,2022-01-28 12:43:00
4361.75,811,981,4362.75,4359.25,4359.75,13,/Date(1643391840000)/,1547,1840,0,0,736,859,0,2022-01-28 12:44:00
4364.25,1242,1673,4364.75,4359.0,4362.25,13,/Date(1643391900000)/,2667,3664,0,0,1425,1991,0,2022-01-28 12:45:00
4362.25,1119,1337,4366.5,4360.75,4364.25,13,/Date(1643391960000)/,2094,2469,0,0,975,1132,0,2022-01-28 12:46:00
4361.0,833,1030,4362.25,4358.75,4362.25,13,/Date(1643392020000)/,1512,1854,0,0,679,824,0,2022-01-28 12:47:00
4359.0,703,871,4361.25,4358.0,4361.0,13,/Date(1643392080000)/,1240,1479,0,0,537,608,0,2022-01-28 12:48:00
4358.0,1236,1706,4359.25,4354.75,4359.0,13,/Date(1643392140000)/,2379,3052,0,0,1143,1346,0,2022-01-28 12:49:00
4358.25,644,754,4360.75,4358.0,4358.25,13,/Date(1643392200000)/,1255,1506,0,0,611,752,0,2022-01-28 12:50:00
4352.5,2130,3291,4358.5,4350.5,4358.5,13,/Date(1643392260000)/,3967,5746,0,0,1837,2455,0,2022-01-28 12:51:00
4353.0,1038,1322,4355.25,4351.75,4352.5,13,/Date(1643392320000)/,2188,2783,0,0,1150,1461,0,2022-01-28 12:52:00
4351.0,1142,1916,4354.75,4350.0,4353.25,13,/Date(1643392380000)/,2243,3383,0,0,1101,1467,0,2022-01-28 12:53:00
4348.0,1544,2859,4351.75,4346.75,4351.25,13,/Date(1643392440000)/,2784,4547,0,0,1240,1688,0,2022-01-28 12:54:00
4349.75,1013,1371,4352.0,4347.5,4348.0,13,/Date(1643392500000)/,1965,2795,0,0,952,1424,0,2022-01-28 12:55:00
4352.25,950,1226,4352.75,4348.75,4349.75,13,/Date(1643392560000)/,1855,2311,0,0,905,1085,0,2022-01-28 12:56:00
4352.0,864,1224,4354.25,4350.25,4352.5,13,/Date(1643392620000)/,1737,2316,0,0,873,1092,0,2022-01-28 12:57:00
4354.5,887,1464,4356.0,4349.25,4352.25,13,/Date(1643392680000)/,1817,2639,0,0,930,1175,0,2022-01-28 12:58:00
4353.25,842,1394,4355.75,4353.0,4354.75,13,/Date(1643392740000)/,1556,2539,0,0,714,1145,0,2022-01-28 12:59:00
4350.5,836,1032,4355.0,4349.5,4353.5,13,/Date(1643392800000)/,1490,1832,0,0,654,800,0,2022-01-28 13:00:00
4351.75,1053,1275,4353.75,4349.5,4351.0,13,/Date(1643392860000)/,1989,2420,0,0,936,1145,0,2022-01-28 13:01:00
4354.0,1012,1396,4354.25,4351.75,4351.75,13,/Date(1643392920000)/,1936,2686,0,0,924,1290,0,2022-01-28 13:02:00
4361.0,1516,1917,4362.0,4353.5,4354.0,13,/Date(1643392980000)/,3207,4252,0,0,1691,2335,0,2022-01-28 13:03:00
4357.5,1525,2136,4361.25,4356.5,4360.75,13,/Date(1643393040000)/,2270,3081,0,0,745,945,0,2022-01-28 13:04:00
4358.25,740,851,4359.25,4356.25,4357.5,13,/Date(1643393100000)/,1374,1662,0,0,634,811,0,2022-01-28 13:05:00
4360.0,1046,1276,4361.0,4356.0,4358.0,13,/Date(1643393160000)/,2007,2494,0,0,961,1218,0,2022-01-28 13:06:00
4361.5,982,1143,4363.75,4358.75,4360.0,13,/Date(1643393220000)/,1945,2317,0,0,963,1174,0,2022-01-28 13:07:00
4364.0,1146,1331,4365.5,4360.25,4361.25,13,/Date(1643393280000)/,2230,2764,0,0,1084,1433,0,2022-01-28 13:08:00
4365.25,749,876,4365.75,4363.5,4363.75,13,/Date(1643393340000)/,1608,1961,0,0,859,1085,0,2022-01-28 13:09:00
4368.0,1489,1925,4370.0,4362.75,4365.25,13,/Date(1643393400000)/,2936,3950,0,0,1447,2025,0,2022-01-28 13:10:00
4367.25,1401,1597,4368.75,4365.5,4368.0,13,/Date(1643393460000)/,2585,3044,0,0,1184,1447,0,2022-01-28 13:11:00
4368.5,938,1165,4370.5,4366.5,4367.25,13,/Date(1643393520000)/,1794,2417,0,0,856,1252,0,2022-01-28 13:12:00
4368.5,976,1435,4369.0,4366.0,4368.5,13,/Date(1643393580000)/,1905,2965,0,0,929,1530,0,2022-01-28 13:13:00
4367.5,799,1143,4368.75,4366.25,4368.0,13,/Date(1643393640000)/,1642,2418,0,0,843,1275,0,2022-01-28 13:14:00
4367.75,699,962,4368.5,4365.75,4367.25,13,/Date(1643393700000)/,1285,1694,0,0,586,732,0,2022-01-28 13:15:00
4367.75,772,973,4369.5,4366.5,4368.25,13,/Date(1643393760000)/,1751,2308,0,0,979,1335,0,2022-01-28 13:16:00
4365.75,828,1023,4367.5,4362.75,4367.5,13,/Date(1643393820000)/,1533,1882,0,0,705,859,0,2022-01-28 13:17:00
4365.0,570,744,4368.0,4364.25,4365.5,13,/Date(1643393880000)/,1162,1474,0,0,592,730,0,2022-01-28 13:18:00
4367.5,515,604,4368.5,4365.0,4365.0,13,/Date(1643393940000)/,991,1164,0,0,476,560,0,2022-01-28 13:19:00
4365.0,726,951,4369.5,4364.5,4367.25,13,/Date(1643394000000)/,1209,1551,0,0,483,600,0,2022-01-28 13:20:00
4364.5,765,956,4365.75,4363.5,4365.0,13,/Date(1643394060000)/,1461,1794,0,0,696,838,0,2022-01-28 13:21:00
4359.5,1199,1701,4365.5,4359.5,4364.75,13,/Date(1643394120000)/,2063,2826,0,0,864,1125,0,2022-01-28 13:22:00
4357.5,947,1160,4359.75,4355.25,4359.75,13,/Date(1643394180000)/,1744,2156,0,0,797,996,0,2022-01-28 13:23:00
4357.5,695,918,4359.0,4355.25,4357.25,13,/Date(1643394240000)/,1418,1813,0,0,723,895,0,2022-01-28 13:24:00
4360.0,640,792,4361.0,4357.0,4357.25,13,/Date(1643394300000)/,1397,1795,0,0,757,1003,0,2022-01-28 13:25:00
4361.25,799,1036,4363.25,4359.75,4360.0,13,/Date(1643394360000)/,1556,1948,0,0,757,912,0,2022-01-28 13:26:00
4358.0,798,955,4362.0,4357.5,4361.25,13,/Date(1643394420000)/,1456,1764,0,0,658,809,0,2022-01-28 13:27:00
4354.75,1379,1670,4358.5,4351.25,4358.25,13,/Date(1643394480000)/,2513,3007,0,0,1134,1337,0,2022-01-28 13:28:00
4357.25,937,1137,4359.5,4355.0,4355.0,13,/Date(1643394540000)/,1890,2290,0,0,953,1153,0,2022-01-28 13:29:00
4361.25,869,1050,4361.5,4355.75,4357.0,13,/Date(1643394600000)/,1734,2120,0,0,865,1070,0,2022-01-28 13:30:00
4371.25,1972,2365,4372.5,4361.25,4361.5,13,/Date(1643394660000)/,4336,5494,0,0,2364,3129,0,2022-01-28 13:31:00
4370.0,1180,1472,4371.0,4368.5,4371.0,13,/Date(1643394720000)/,2285,2793,0,0,1105,1321,0,2022-01-28 13:32:00
4368.25,797,984,4370.0,4367.25,4370.0,13,/Date(1643394780000)/,1640,1994,0,0,843,1010,0,2022-01-28 13:33:00
4369.0,933,1164,4371.5,4368.0,4368.25,13,/Date(1643394840000)/,1875,2431,0,0,942,1267,0,2022-01-28 13:34:00
4367.5,962,1360,4370.5,4367.5,4369.25,13,/Date(1643394900000)/,1767,2579,0,0,805,1219,0,2022-01-28 13:35:00
4370.75,646,749,4371.25,4366.25,4367.75,13,/Date(1643394960000)/,1436,1677,0,0,790,928,0,2022-01-28 13:36:00
4369.5,2428,3215,4374.0,4368.25,4370.75,13,/Date(1643395020000)/,4508,6453,0,0,2080,3238,0,2022-01-28 13:37:00
4365.75,1260,1488,4370.0,4363.75,4369.5,13,/Date(1643395080000)/,2128,2529,0,0,868,1041,0,2022-01-28 13:38:00
4368.75,685,820,4370.5,4365.25,4366.0,13,/Date(1643395140000)/,1448,1762,0,0,763,942,0,2022-01-28 13:39:00
4367.25,768,908,4369.75,4366.25,4368.75,13,/Date(1643395200000)/,1418,1630,0,0,650,722,0,2022-01-28 13:40:00
4366.5,1132,1372,4368.0,4363.0,4367.25,13,/Date(1643395260000)/,1934,2302,0,0,802,930,0,2022-01-28 13:41:00
4364.25,649,751,4367.75,4363.75,4366.75,13,/Date(1643395320000)/,1169,1346,0,0,520,595,0,2022-01-28 13:42:00
4367.0,396,461,4367.5,4364.5,4364.5,13,/Date(1643395380000)/,876,1008,0,0,480,547,0,2022-01-28 13:43:00
4366.0,1022,1216,4369.0,4362.25,4367.25,13,/Date(1643395440000)/,1857,2168,0,0,835,952,0,2022-01-28 13:44:00
4366.0,709,841,4369.25,4365.5,4366.25,13,/Date(1643395500000)/,1419,1678,0,0,710,837,0,2022-01-28 13:45:00
4364.75,655,766,4367.75,4364.0,4366.0,13,/Date(1643395560000)/,1309,1506,0,0,654,740,0,2022-01-28 13:46:00
4366.25,947,1123,4370.0,4364.25,4365.0,13,/Date(1643395620000)/,1826,2134,0,0,879,1011,0,2022-01-28 13:47:00
4366.5,732,858,4367.0,4363.0,4366.25,13,/Date(1643395680000)/,1565,1831,0,0,833,973,0,2022-01-28 13:48:00
4369.0,1162,1393,4372.5,4366.5,4366.5,13,/Date(1643395740000)/,2532,3070,0,0,1370,1677,0,2022-01-28 13:49:00
4366.0,980,1186,4370.25,4364.25,4368.75,13,/Date(1643395800000)/,1858,2243,0,0,878,1057,0,2022-01-28 13:50:00
4366.5,716,892,4368.5,4364.5,4366.0,13,/Date(1643395860000)/,1527,1875,0,0,811,983,0,2022-01-28 13:51:00
4370.5,625,736,4370.75,4364.25,4366.5,13,/Date(1643395920000)/,1405,1678,0,0,780,942,0,2022-01-28 13:52:00
4368.75,1039,1276,4371.0,4367.25,4370.25,13,/Date(1643395980000)/,1836,2171,0,0,797,895,0,2022-01-28 13:53:00
4370.75,560,705,4371.5,4368.25,4368.75,13,/Date(1643396040000)/,1282,1634,0,0,722,929,0,2022-01-28 13:54:00
4370.0,1114,1409,4373.75,4369.5,4371.0,13,/Date(1643396100000)/,1949,2484,0,0,835,1075,0,2022-01-28 13:55:00
4371.0,692,797,4371.25,4368.0,4370.25,13,/Date(1643396160000)/,1397,1687,0,0,705,890,0,2022-01-28 13:56:00
4369.25,1011,1284,4373.75,4368.5,4370.75,13,/Date(1643396220000)/,1726,2123,0,0,715,839,0,2022-01-28 13:57:00
4370.0,764,900,4370.75,4367.5,4369.5,13,/Date(1643396280000)/,1432,1688,0,0,668,788,0,2022-01-28 13:58:00
4370.5,1394,2051,4373.25,4369.25,4370.25,13,/Date(1643396340000)/,2577,3920,0,0,1183,1869,0,2022-01-28 13:59:00
4367.25,1368,1782,4374.25,4367.0,4370.75,13,/Date(1643396400000)/,2304,2918,0,0,936,1136,0,2022-01-28 14:00:00
4371.25,2227,2759,4376.5,4366.75,4367.0,13,/Date(1643396460000)/,4546,5788,0,0,2319,3029,0,2022-01-28 14:01:00
4370.75,1174,1435,4374.75,4369.5,4371.25,13,/Date(1643396520000)/,2551,3180,0,0,1377,1745,0,2022-01-28 14:02:00
4364.75,1356,1677,4372.0,4364.25,4370.75,13,/Date(1643396580000)/,2411,2860,0,0,1055,1183,0,2022-01-28 14:03:00
4366.25,1173,1428,4366.75,4363.0,4365.0,13,/Date(1643396640000)/,2435,2908,0,0,1262,1480,0,2022-01-28 14:04:00
4362.0,1159,1404,4367.5,4361.5,4366.5,13,/Date(1643396700000)/,2043,2478,0,0,884,1074,0,2022-01-28 14:05:00
4361.5,1446,2417,4362.5,4360.0,4362.0,13,/Date(1643396760000)/,3072,4703,0,0,1626,2286,0,2022-01-28 14:06:00
4356.5,2515,4580,4363.0,4355.0,4361.75,13,/Date(1643396820000)/,4387,7228,0,0,1872,2648,0,2022-01-28 14:07:00
4353.5,1748,3386,4356.75,4353.0,4356.5,13,/Date(1643396880000)/,3099,5229,0,0,1351,1843,0,2022-01-28 14:08:00
4353.5,990,1197,4355.25,4352.0,4353.5,13,/Date(1643396940000)/,2034,2520,0,0,1044,1323,0,2022-01-28 14:09:00
4354.5,643,748,4355.5,4352.5,4353.25,13,/Date(1643397000000)/,1341,1586,0,0,698,838,0,2022-01-28 14:10:00
4355.25,793,975,4355.75,4352.5,4354.5,13,/Date(1643397060000)/,1541,1849,0,0,748,874,0,2022-01-28 14:11:00
4350.25,1723,2615,4355.25,4348.0,4355.0,13,/Date(1643397120000)/,3161,4542,0,0,1438,1927,0,2022-01-28 14:12:00
4350.25,705,830,4350.75,4348.75,4350.25,13,/Date(1643397180000)/,1561,1823,0,0,856,993,0,2022-01-28 14:13:00
4349.0,529,626,4350.75,4348.5,4350.25,13,/Date(1643397240000)/,1064,1294,0,0,535,668,0,2022-01-28 14:14:00
4345.75,1638,2366,4349.0,4345.0,4349.0,13,/Date(1643397300000)/,3126,4457,0,0,1488,2091,0,2022-01-28 14:15:00
4343.25,1379,2422,4345.5,4342.0,4345.5,13,/Date(1643397360000)/,2603,3907,0,0,1224,1485,0,2022-01-28 14:16:00
4340.75,1472,2214,4343.5,4340.0,4343.25,13,/Date(1643397420000)/,2861,4132,0,0,1389,1918,0,2022-01-28 14:17:00
4342.25,1620,2356,4345.5,4340.25,4340.75,13,/Date(1643397480000)/,3249,4586,0,0,1629,2230,0,2022-01-28 14:18:00
4341.75,881,1265,4343.0,4340.25,4342.0,13,/Date(1643397540000)/,1780,2431,0,0,899,1166,0,2022-01-28 14:19:00
4341.0,1205,1649,4342.25,4340.0,4341.5,13,/Date(1643397600000)/,2459,3391,0,0,1254,1742,0,2022-01-28 14:20:00
4339.0,2140,3859,4341.0,4335.75,4340.75,13,/Date(1643397660000)/,3656,5953,0,0,1516,2094,0,2022-01-28 14:21:00
4337.5,1017,1293,4339.0,4336.0,4338.75,13,/Date(1643397720000)/,1959,2440,0,0,942,1147,0,2022-01-28 14:22:00
4336.5,1248,1604,4337.5,4335.25,4337.5,13,/Date(1643397780000)/,2197,2826,0,0,949,1222,0,2022-01-28 14:23:00
4335.25,1745,2249,4337.5,4331.75,4336.5,13,/Date(1643397840000)/,3888,4972,0,0,2143,2723,0,2022-01-28 14:24:00
4328.75,1969,2776,4337.0,4328.75,4335.5,13,/Date(1643397900000)/,3455,4662,0,0,1486,1886,0,2022-01-28 14:25:00
4332.5,1410,1670,4333.0,4328.75,4329.25,13,/Date(1643397960000)/,3330,4307,0,0,1920,2637,0,2022-01-28 14:26:00
4334.5,1172,1552,4334.75,4329.25,4332.75,13,/Date(1643398020000)/,2777,3781,0,0,1605,2229,0,2022-01-28 14:27:00
4333.75,1466,1783,4336.25,4333.0,4334.5,13,/Date(1643398080000)/,2794,3449,0,0,1328,1666,0,2022-01-28 14:28:00
4333.0,790,978,4335.0,4332.5,4334.0,13,/Date(1643398140000)/,1678,2276,0,0,888,1298,0,2022-01-28 14:29:00
4330.75,1198,1588,4333.75,4330.0,4333.25,13,/Date(1643398200000)/,2279,3110,0,0,1081,1522,0,2022-01-28 14:30:00
4327.75,2746,4041,4331.0,4322.75,4330.75,13,/Date(1643398260000)/,5489,7531,0,0,2743,3490,0,2022-01-28 14:31:00
4334.25,1510,1771,4334.5,4326.75,4327.75,13,/Date(1643398320000)/,3467,4157,0,0,1957,2386,0,2022-01-28 14:32:00
4335.75,1413,1756,4336.25,4331.5,4334.5,13,/Date(1643398380000)/,2792,3502,0,0,1379,1746,0,2022-01-28 14:33:00
4331.75,1253,1585,4335.75,4330.75,4335.5,13,/Date(1643398440000)/,2182,2688,0,0,929,1103,0,2022-01-28 14:34:00
4330.25,1212,1453,4333.5,4329.0,4331.75,13,/Date(1643398500000)/,2260,2712,0,0,1048,1259,0,2022-01-28 14:35:00
4332.25,873,971,4333.75,4329.25,4330.0,13,/Date(1643398560000)/,2076,2642,0,0,1203,1671,0,2022-01-28 14:36:00
4335.75,1023,1255,4337.25,4331.75,4332.25,13,/Date(1643398620000)/,2239,2951,0,0,1216,1696,0,2022-01-28 14:37:00
4333.5,1016,1187,4336.0,4331.75,4335.75,13,/Date(1643398680000)/,1779,2159,0,0,763,972,0,2022-01-28 14:38:00
4332.5,1094,1381,4334.5,4331.75,4333.25,13,/Date(1643398740000)/,1999,2721,0,0,905,1340,0,2022-01-28 14:39:00
4336.75,1437,1778,4337.0,4329.5,4332.25,13,/Date(1643398800000)/,3133,4040,0,0,1696,2262,0,2022-01-28 14:40:00
4340.5,2604,3171,4345.25,4336.25,4336.5,13,/Date(1643398860000)/,5598,7096,0,0,2994,3925,0,2022-01-28 14:41:00
4344.25,1338,1734,4344.25,4340.25,4340.5,13,/Date(1643398920000)/,2867,3941,0,0,1529,2207,0,2022-01-28 14:42:00
4348.5,1849,2337,4351.0,4344.0,4344.0,13,/Date(1643398980000)/,4109,5377,0,0,2260,3040,0,2022-01-28 14:43:00
4348.0,1108,1318,4349.75,4345.75,4348.25,13,/Date(1643399040000)/,2331,2955,0,0,1223,1637,0,2022-01-28 14:44:00
4349.75,1060,1265,4351.5,4347.5,4348.0,13,/Date(1643399100000)/,2246,2772,0,0,1186,1507,0,2022-01-28 14:45:00
4349.75,1338,1597,4352.5,4348.5,4349.5,13,/Date(1643399160000)/,2511,3014,0,0,1173,1417,0,2022-01-28 14:46:00
4347.5,1431,1761,4351.0,4345.5,4349.5,13,/Date(1643399220000)/,2756,3450,0,0,1325,1689,0,2022-01-28 14:47:00
4350.0,823,1032,4350.25,4347.0,4347.75,13,/Date(1643399280000)/,1734,2226,0,0,911,1194,0,2022-01-28 14:48:00
4354.0,1879,2465,4356.5,4349.25,4349.75,13,/Date(1643399340000)/,3734,4868,0,0,1855,2403,0,2022-01-28 14:49:00
4356.75,860,1020,4357.5,4353.0,4354.0,13,/Date(1643399400000)/,1980,2496,0,0,1120,1476,0,2022-01-28 14:50:00
4353.75,1133,1480,4358.0,4353.25,4357.25,13,/Date(1643399460000)/,2170,2769,0,0,1037,1289,0,2022-01-28 14:51:00
4355.0,830,1017,4356.25,4353.25,4353.5,13,/Date(1643399520000)/,1737,2206,0,0,907,1189,0,2022-01-28 14:52:00
4358.0,966,1193,4358.75,4354.25,4354.75,13,/Date(1643399580000)/,2079,2977,0,0,1113,1784,0,2022-01-28 14:53:00
4355.25,1575,2231,4360.5,4354.25,4358.0,13,/Date(1643399640000)/,3012,4173,0,0,1437,1942,0,2022-01-28 14:54:00
4356.25,1379,1743,4356.75,4350.5,4355.25,13,/Date(1643399700000)/,2690,3470,0,0,1311,1727,0,2022-01-28 14:55:00
4364.75,2317,2907,4366.5,4354.5,4356.0,13,/Date(1643399760000)/,4791,6100,0,0,2474,3193,0,2022-01-28 14:56:00
4363.25,1773,2223,4367.0,4362.75,4364.5,13,/Date(1643399820000)/,3391,4399,0,0,1618,2176,0,2022-01-28 14:57:00
4365.0,639,730,4365.5,4362.75,4363.0,13,/Date(1643399880000)/,1389,1726,0,0,750,996,0,2022-01-28 14:58:00
4363.75,670,812,4365.25,4362.5,4364.75,13,/Date(1643399940000)/,1203,1504,0,0,533,692,0,2022-01-28 14:59:00
4365.5,1051,1295,4368.0,4363.75,4364.0,13,/Date(1643400000000)/,2280,3037,0,0,1229,1742,0,2022-01-28 15:00:00
4368.0,1730,2160,4371.25,4365.5,4365.5,13,/Date(1643400060000)/,3426,4434,0,0,1696,2274,0,2022-01-28 15:01:00
4365.75,1596,1984,4369.75,4364.0,4368.0,13,/Date(1643400120000)/,3009,3871,0,0,1413,1887,0,2022-01-28 15:02:00
4365.5,1390,1788,4366.5,4362.25,4365.75,13,/Date(1643400180000)/,2587,3352,0,0,1197,1564,0,2022-01-28 15:03:00
4368.25,1298,1546,4371.25,4364.75,4365.25,13,/Date(1643400240000)/,2692,3345,0,0,1394,1799,0,2022-01-28 15:04:00
4368.0,1282,1549,4371.25,4367.25,4368.25,13,/Date(1643400300000)/,2406,3038,0,0,1124,1489,0,2022-01-28 15:05:00
4368.0,1271,1755,4371.0,4366.75,4368.0,13,/Date(1643400360000)/,2523,3518,0,0,1252,1763,0,2022-01-28 15:06:00
4367.25,1035,1424,4369.25,4366.25,4368.0,13,/Date(1643400420000)/,1718,2352,0,0,683,928,0,2022-01-28 15:07:00
4368.25,704,856,4370.0,4366.75,4367.25,13,/Date(1643400480000)/,1363,1727,0,0,659,871,0,2022-01-28 15:08:00
4371.25,1115,1414,4372.75,4367.0,4368.0,13,/Date(1643400540000)/,2280,3081,0,0,1165,1667,0,2022-01-28 15:09:00
4371.5,860,1107,4372.75,4370.0,4371.25,13,/Date(1643400600000)/,1613,2051,0,0,753,944,0,2022-01-28 15:10:00
4369.25,1329,1764,4371.75,4366.5,4371.5,13,/Date(1643400660000)/,2537,3226,0,0,1208,1462,0,2022-01-28 15:11:00
4363.75,1518,1909,4370.0,4362.0,4369.25,13,/Date(1643400720000)/,2693,3419,0,0,1175,1510,0,2022-01-28 15:12:00
4362.75,1308,1753,4365.25,4361.0,4363.5,13,/Date(1643400780000)/,2574,3366,0,0,1266,1613,0,2022-01-28 15:13:00
4361.75,892,1316,4363.75,4360.75,4362.75,13,/Date(1643400840000)/,1884,2603,0,0,992,1287,0,2022-01-28 15:14:00
4366.0,940,1226,4367.0,4361.75,4361.75,13,/Date(1643400900000)/,2100,2684,0,0,1160,1458,0,2022-01-28 15:15:00
4371.5,1746,2211,4374.25,4366.0,4366.0,13,/Date(1643400960000)/,3721,4786,0,0,1975,2575,0,2022-01-28 15:16:00
4369.0,1129,1396,4372.75,4367.25,4371.5,13,/Date(1643401020000)/,2062,2511,0,0,933,1115,0,2022-01-28 15:17:00
4365.0,1043,1296,4370.0,4364.75,4369.0,13,/Date(1643401080000)/,1730,2094,0,0,687,798,0,2022-01-28 15:18:00
4368.0,727,895,4369.25,4364.0,4365.25,13,/Date(1643401140000)/,1541,1825,0,0,814,930,0,2022-01-28 15:19:00
4370.5,866,1017,4371.5,4367.25,4367.75,13,/Date(1643401200000)/,1825,2199,0,0,959,1182,0,2022-01-28 15:20:00
4378.0,2203,2694,4378.0,4367.25,4370.5,13,/Date(1643401260000)/,4988,6075,0,0,2785,3381,0,2022-01-28 15:21:00
4379.75,2283,3079,4382.0,4376.75,4377.75,13,/Date(1643401320000)/,4313,6784,0,0,2030,3705,0,2022-01-28 15:22:00
4380.75,943,1166,4381.75,4378.75,4379.75,13,/Date(1643401380000)/,1882,2367,0,0,939,1201,0,2022-01-28 15:23:00
4378.0,1291,1721,4382.0,4377.25,4380.75,13,/Date(1643401440000)/,2569,3387,0,0,1278,1666,0,2022-01-28 15:24:00
4381.25,709,869,4381.25,4377.5,4377.75,13,/Date(1643401500000)/,1845,2484,0,0,1136,1615,0,2022-01-28 15:25:00
4379.5,1624,2083,4383.5,4378.5,4381.5,13,/Date(1643401560000)/,3284,4951,0,0,1660,2868,0,2022-01-28 15:26:00
4377.25,1826,2206,4379.75,4373.5,4379.75,13,/Date(1643401620000)/,3421,4142,0,0,1595,1936,0,2022-01-28 15:27:00
4377.5,974,1197,4379.0,4375.0,4377.5,13,/Date(1643401680000)/,1889,2363,0,0,915,1166,0,2022-01-28 15:28:00
4375.25,853,1173,4379.0,4375.0,4377.5,13,/Date(1643401740000)/,1865,2463,0,0,1012,1290,0,2022-01-28 15:29:00
4377.5,1439,1936,4379.25,4374.75,4375.5,13,/Date(1643401800000)/,3032,4586,0,0,1593,2650,0,2022-01-28 15:30:00
4370.75,2367,3065,4377.75,4367.75,4377.5,13,/Date(1643401860000)/,4263,5430,0,0,1896,2365,0,2022-01-28 15:31:00
4368.25,1559,2060,4371.0,4364.75,4370.75,13,/Date(1643401920000)/,2886,3705,0,0,1327,1645,0,2022-01-28 15:32:00
4374.0,1587,2004,4374.75,4368.0,4368.25,13,/Date(1643401980000)/,3325,4125,0,0,1738,2121,0,2022-01-28 15:33:00
4382.5,3694,5165,4386.25,4373.75,4374.25,13,/Date(1643402040000)/,8241,11256,0,0,4547,6091,0,2022-01-28 15:34:00
4385.5,1998,2667,4388.75,4381.5,4382.5,13,/Date(1643402100000)/,4246,5643,0,0,2248,2976,0,2022-01-28 15:35:00
4386.0,1540,1923,4386.25,4382.25,4385.5,13,/Date(1643402160000)/,3205,3965,0,0,1665,2042,0,2022-01-28 15:36:00
4386.75,1683,2169,4389.5,4385.75,4385.75,13,/Date(1643402220000)/,3570,4611,0,0,1887,2442,0,2022-01-28 15:37:00
4387.75,1505,1878,4388.75,4383.0,4386.75,13,/Date(1643402280000)/,3244,4246,0,0,1739,2368,0,2022-01-28 15:38:00
4385.5,1675,2127,4388.5,4384.25,4387.5,13,/Date(1643402340000)/,2952,3715,0,0,1277,1588,0,2022-01-28 15:39:00
4387.5,985,1192,4388.75,4385.0,4385.5,13,/Date(1643402400000)/,2083,2610,0,0,1098,1418,0,2022-01-28 15:40:00
4388.75,1502,2102,4390.5,4386.5,4387.5,13,/Date(1643402460000)/,3217,4424,0,0,1715,2322,0,2022-01-28 15:41:00
4389.25,1153,1502,4390.75,4387.5,4388.5,13,/Date(1643402520000)/,2413,3177,0,0,1260,1675,0,2022-01-28 15:42:00
4390.5,1012,1227,4390.5,4388.0,4389.25,13,/Date(1643402580000)/,2093,2612,0,0,1081,1385,0,2022-01-28 15:43:00
4392.75,1441,1846,4393.5,4389.75,4390.5,13,/Date(1643402640000)/,2969,4051,0,0,1528,2205,0,2022-01-28 15:44:00
4394.75,1821,2974,4396.0,4392.0,4392.75,13,/Date(1643402700000)/,3941,6695,0,0,2120,3721,0,2022-01-28 15:45:00
4392.0,2323,2937,4394.75,4390.25,4394.75,13,/Date(1643402760000)/,4346,5531,0,0,2023,2594,0,2022-01-28 15:46:00
4396.25,1900,2397,4397.5,4391.5,4392.0,13,/Date(1643402820000)/,4070,5148,0,0,2170,2751,0,2022-01-28 15:47:00
4398.5,2281,3192,4398.75,4395.0,4396.5,13,/Date(1643402880000)/,4943,6800,0,0,2662,3608,0,2022-01-28 15:48:00
4399.0,1871,2617,4400.0,4397.25,4398.5,13,/Date(1643402940000)/,3929,6101,0,0,2058,3484,0,2022-01-28 15:49:00
4404.0,2844,3930,4405.0,4398.75,4399.0,13,/Date(1643403000000)/,6022,8691,0,0,3178,4761,0,2022-01-28 15:50:00
4411.25,5803,7775,4413.75,4404.0,4404.0,13,/Date(1643403060000)/,11920,16493,0,0,6117,8718,0,2022-01-28 15:51:00
4411.0,2909,3906,4411.5,4406.25,4411.25,13,/Date(1643403120000)/,5593,7511,0,0,2684,3605,0,2022-01-28 15:52:00
4407.0,2303,3329,4412.0,4406.5,4411.0,13,/Date(1643403180000)/,3896,5567,0,0,1593,2238,0,2022-01-28 15:53:00
4408.0,1824,2451,4408.5,4404.75,4406.75,13,/Date(1643403240000)/,3566,4810,0,0,1742,2359,0,2022-01-28 15:54:00
4412.5,3335,4651,4414.5,4408.0,4408.25,13,/Date(1643403300000)/,6661,9297,0,0,3326,4646,0,2022-01-28 15:55:00
4410.5,4903,6633,4415.0,4410.0,4412.5,13,/Date(1643403360000)/,9897,13780,0,0,4994,7147,0,2022-01-28 15:56:00
4417.0,2605,3698,4418.0,4410.0,4410.25,13,/Date(1643403420000)/,6104,8866,0,0,3499,5168,0,2022-01-28 15:57:00
4418.0,3268,4768,4419.75,4415.5,4417.25,13,/Date(1643403480000)/,6296,9441,0,0,3028,4673,0,2022-01-28 15:58:00
4420.25,4032,6094,4420.75,4415.0,4418.0,13,/Date(1643403540000)/,8024,12942,0,0,3992,6848,0,2022-01-28 15:59:00
4424.0,10190,32082,4425.0,4420.25,4420.25,13,/Date(1643403600000)/,22000,66912,0,0,11810,34830,0,2022-01-28 16:00:00
4418.75,6446,14661,4426.0,4417.25,4424.0,13,/Date(1643403660000)/,12303,29255,0,0,5857,14594,0,2022-01-28 16:01:00
4419.5,2150,3326,4423.25,4419.0,4419.0,13,/Date(1643403720000)/,4518,7220,0,0,2368,3894,0,2022-01-28 16:02:00
4424.75,1302,2057,4425.25,4419.5,4419.75,13,/Date(1643403780000)/,3142,5113,0,0,1840,3056,0,2022-01-28 16:03:00
4423.0,1103,1688,4425.5,4422.75,4425.0,13,/Date(1643403840000)/,2344,3665,0,0,1241,1977,0,2022-01-28 16:04:00
4422.5,1099,1899,4424.75,4421.5,4423.25,13,/Date(1643403900000)/,2266,3829,0,0,1167,1930,0,2022-01-28 16:05:00
4424.25,758,1268,4425.0,4422.5,4422.75,13,/Date(1643403960000)/,1817,3151,0,0,1059,1883,0,2022-01-28 16:06:00
4423.0,957,1732,4425.25,4422.25,4424.5,13,/Date(1643404020000)/,1631,2791,0,0,674,1059,0,2022-01-28 16:07:00
4422.25,614,960,4423.75,4422.0,4423.25,13,/Date(1643404080000)/,1246,1842,0,0,632,882,0,2022-01-28 16:08:00
4424.0,830,1457,4425.0,4421.5,4422.25,13,/Date(1643404140000)/,1640,2756,0,0,810,1299,0,2022-01-28 16:09:00
4422.0,742,1146,4424.25,4420.75,4423.75,13,/Date(1643404200000)/,1163,1821,0,0,421,675,0,2022-01-28 16:10:00
4419.25,848,1408,4422.0,4418.75,4421.75,13,/Date(1643404260000)/,1369,2213,0,0,521,805,0,2022-01-28 16:11:00
4418.75,445,814,4419.5,4417.25,4419.0,13,/Date(1643404320000)/,854,1453,0,0,409,639,0,2022-01-28 16:12:00
4419.0,722,1398,4422.0,4418.25,4418.75,13,/Date(1643404380000)/,1588,3378,0,0,866,1980,0,2022-01-28 16:13:00
4414.75,789,1456,4419.0,4414.5,4419.0,13,/Date(1643404440000)/,1379,2536,0,0,590,1080,0,2022-01-28 16:14:00
4413.25,796,1472,4415.0,4412.5,4414.75,13,/Date(1643404500000)/,1543,2782,0,0,747,1310,0,2022-01-28 16:15:00
4416.0,201,372,4416.0,4412.75,4413.0,13,/Date(1643404560000)/,571,1020,0,0,370,648,0,2022-01-28 16:16:00
4417.75,157,255,4418.0,4415.75,4416.0,13,/Date(1643404620000)/,385,614,0,0,228,359,0,2022-01-28 16:17:00
4418.5,254,595,4418.75,4417.25,4417.5,13,/Date(1643404680000)/,513,999,0,0,259,404,0,2022-01-28 16:18:00
4420.75,137,222,4421.0,4417.5,4418.75,13,/Date(1643404740000)/,410,668,0,0,273,446,0,2022-01-28 16:19:00
4417.0,469,871,4421.5,4416.5,4420.75,13,/Date(1643404800000)/,781,1402,0,0,312,531,0,2022-01-28 16:20:00
4418.25,270,385,4418.75,4415.75,4417.0,13,/Date(1643404860000)/,552,986,0,0,282,601,0,2022-01-28 16:21:00
4417.75,209,334,4418.75,4417.0,4418.25,13,/Date(1643404920000)/,403,807,0,0,194,473,0,2022-01-28 16:22:00
4420.0,59,94,4420.5,4417.5,4417.5,13,/Date(1643404980000)/,237,456,0,0,178,362,0,2022-01-28 16:23:00
4419.75,95,176,4420.25,4419.25,4419.75,13,/Date(1643405040000)/,166,324,0,0,71,148,0,2022-01-28 16:24:00
4418.75,116,210,4420.75,4418.25,4420.0,13,/Date(1643405100000)/,254,452,0,0,138,242,0,2022-01-28 16:25:00
4417.75,150,307,4419.25,4417.5,4419.0,13,/Date(1643405160000)/,267,605,0,0,117,298,0,2022-01-28 16:26:00
4419.0,68,100,4419.5,4417.75,4417.75,13,/Date(1643405220000)/,179,338,0,0,111,238,0,2022-01-28 16:27:00
4419.5,49,78,4419.5,4418.5,4419.25,13,/Date(1643405280000)/,126,217,0,0,77,139,0,2022-01-28 16:28:00
4418.25,81,166,4419.5,4418.25,4419.25,13,/Date(1643405340000)/,134,268,0,0,53,102,0,2022-01-28 16:29:00
4420.75,108,203,4421.25,4418.0,4418.0,13,/Date(1643405400000)/,393,651,0,0,285,448,0,2022-01-28 16:30:00
4419.75,138,267,4420.25,4418.75,4420.25,13,/Date(1643405460000)/,224,384,0,0,86,117,0,2022-01-28 16:31:00
4418.25,164,259,4420.0,4418.25,4419.5,13,/Date(1643405520000)/,208,315,0,0,44,56,0,2022-01-28 16:32:00
4418.75,89,165,4419.5,4418.25,4418.5,13,/Date(1643405580000)/,195,303,0,0,106,138,0,2022-01-28 16:33:00
4419.25,37,52,4419.75,4418.5,4418.75,13,/Date(1643405640000)/,112,166,0,0,75,114,0,2022-01-28 16:34:00
4420.0,19,41,4420.0,4419.25,4419.25,13,/Date(1643405700000)/,92,150,0,0,73,109,0,2022-01-28 16:35:00
4420.75,31,63,4420.75,4419.5,4420.0,13,/Date(1643405760000)/,138,295,0,0,107,232,0,2022-01-28 16:36:00
4420.25,84,182,4420.75,4420.0,4420.75,13,/Date(1643405820000)/,137,294,0,0,53,112,0,2022-01-28 16:37:00
4421.25,41,59,4421.5,4420.0,4420.25,13,/Date(1643405880000)/,181,311,0,0,140,252,0,2022-01-28 16:38:00
4420.5,129,172,4421.25,4420.0,4421.0,13,/Date(1643405940000)/,227,333,0,0,98,161,0,2022-01-28 16:39:00
4421.5,51,80,4421.5,4420.5,4420.5,13,/Date(1643406000000)/,209,383,0,0,158,303,0,2022-01-28 16:40:00
4422.25,90,119,4422.5,4421.25,4421.25,13,/Date(1643406060000)/,187,364,0,0,97,245,0,2022-01-28 16:41:00
4422.5,62,95,4423.0,4421.75,4422.25,13,/Date(1643406120000)/,168,288,0,0,106,193,0,2022-01-28 16:42:00
4422.75,67,113,4423.0,4422.25,4422.5,13,/Date(1643406180000)/,148,301,0,0,81,188,0,2022-01-28 16:43:00
4422.0,139,257,4423.0,4421.75,4422.75,13,/Date(1643406240000)/,235,397,0,0,96,140,0,2022-01-28 16:44:00
4422.25,60,76,4422.5,4421.5,4421.75,13,/Date(1643406300000)/,138,214,0,0,78,138,0,2022-01-28 16:45:00
4422.0,95,134,4422.5,4421.75,4422.25,13,/Date(1643406360000)/,173,257,0,0,78,123,0,2022-01-28 16:46:00
4421.5,109,168,4422.25,4421.0,4422.0,13,/Date(1643406420000)/,133,215,0,0,24,47,0,2022-01-28 16:47:00
4421.75,37,42,4422.0,4421.0,4421.25,13,/Date(1643406480000)/,84,122,0,0,47,80,0,2022-01-28 16:48:00
4421.5,34,38,4422.0,4421.5,4421.75,13,/Date(1643406540000)/,49,54,0,0,15,16,0,2022-01-28 16:49:00
4420.75,152,246,4422.0,4420.5,4421.5,13,/Date(1643406600000)/,230,485,0,0,78,239,0,2022-01-28 16:50:00
4420.25,137,217,4420.75,4419.75,4420.5,13,/Date(1643406660000)/,221,416,0,0,84,199,0,2022-01-28 16:51:00
4420.0,54,80,4421.0,4420.0,4420.25,13,/Date(1643406720000)/,121,176,0,0,67,96,0,2022-01-28 16:52:00
4420.25,107,258,4420.75,4420.0,4420.0,13,/Date(1643406780000)/,155,341,0,0,48,83,0,2022-01-28 16:53:00
4421.5,54,89,4421.5,4420.25,4420.25,13,/Date(1643406840000)/,133,195,0,0,79,106,0,2022-01-28 16:54:00
4421.5,99,140,4422.0,4420.5,4421.25,13,/Date(1643406900000)/,219,351,0,0,120,211,0,2022-01-28 16:55:00
4420.5,118,177,4422.0,4420.25,4421.75,13,/Date(1643406960000)/,173,251,0,0,55,74,0,2022-01-28 16:56:00
4420.0,52,99,4420.75,4420.0,4420.25,13,/Date(1643407020000)/,113,190,0,0,61,91,0,2022-01-28 16:57:00
4420.25,106,248,4420.75,4419.75,4420.25,13,/Date(1643407080000)/,171,379,0,0,65,131,0,2022-01-28 16:58:00
4420.5,185,305,4420.5,4419.5,4420.25,13,/Date(1643407140000)/,272,469,0,0,87,164,0,2022-01-28 16:59:00
4419.75,157,261,4420.25,4419.0,4420.25,29,/Date(1643407200000)/,276,543,0,0,119,282,0,2022-01-28 17:00:00
4424.0,611,877,4427.75,4421.25,4423.5,13,/Date(1643583660000)/,1307,2170,0,0,696,1293,0,2022-01-30 18:01:00
4418.75,474,766,4424.75,4418.5,4424.0,13,/Date(1643583720000)/,785,1222,0,0,311,456,0,2022-01-30 18:02:00
4420.0,235,289,4421.0,4418.5,4418.75,13,/Date(1643583780000)/,577,777,0,0,342,488,0,2022-01-30 18:03:00
4416.5,450,711,4420.0,4415.75,4420.0,13,/Date(1643583840000)/,688,978,0,0,238,267,0,2022-01-30 18:04:00
4416.5,351,494,4417.75,4414.0,4416.5,13,/Date(1643583900000)/,671,883,0,0,320,389,0,2022-01-30 18:05:00
4417.75,129,160,4418.0,4415.5,4416.5,13,/Date(1643583960000)/,309,430,0,0,180,270,0,2022-01-30 18:06:00
4420.0,147,242,4420.25,4417.5,4417.75,13,/Date(1643584020000)/,345,579,0,0,198,337,0,2022-01-30 18:07:00
4420.5,205,280,4422.5,4419.75,4420.0,13,/Date(1643584080000)/,444,639,0,0,239,359,0,2022-01-30 18:08:00
4418.5,117,162,4420.75,4418.0,4420.25,13,/Date(1643584140000)/,176,246,0,0,59,84,0,2022-01-30 18:09:00
4419.75,72,137,4419.75,4417.5,4418.25,13,/Date(1643584200000)/,148,266,0,0,76,129,0,2022-01-30 18:10:00
4418.75,57,68,4420.5,4418.25,4419.75,13,/Date(1643584260000)/,108,128,0,0,51,60,0,2022-01-30 18:11:00
4417.75,92,125,4418.75,4417.25,4418.25,13,/Date(1643584320000)/,153,188,0,0,61,63,0,2022-01-30 18:12:00
4415.0,322,443,4417.5,4413.75,4417.5,13,/Date(1643584380000)/,460,609,0,0,138,166,0,2022-01-30 18:13:00
4416.0,95,113,4416.75,4414.75,4414.75,13,/Date(1643584440000)/,207,260,0,0,112,147,0,2022-01-30 18:14:00
4414.75,161,206,4415.75,4413.5,4415.75,13,/Date(1643584500000)/,284,339,0,0,123,133,0,2022-01-30 18:15:00
4415.75,50,51,4416.25,4413.75,4414.5,13,/Date(1643584560000)/,131,141,0,0,81,90,0,2022-01-30 18:16:00
4411.0,367,478,4415.75,4410.75,4415.75,13,/Date(1643584620000)/,584,710,0,0,217,232,0,2022-01-30 18:17:00
4410.5,219,251,4412.25,4410.25,4410.75,13,/Date(1643584680000)/,389,453,0,0,170,202,0,2022-01-30 18:18:00
4409.25,291,459,4410.75,4408.25,4410.75,13,/Date(1643584740000)/,492,679,0,0,201,220,0,2022-01-30 18:19:00
4410.5,67,73,4410.75,4408.75,4409.25,13,/Date(1643584800000)/,160,178,0,0,93,105,0,2022-01-30 18:20:00
4410.75,92,115,4411.75,4410.0,4410.5,13,/Date(1643584860000)/,213,246,0,0,121,131,0,2022-01-30 18:21:00
4411.75,70,84,4412.25,4410.0,4410.75,13,/Date(1643584920000)/,196,243,0,0,126,159,0,2022-01-30 18:22:00
4410.75,116,138,4412.0,4410.0,4411.75,13,/Date(1643584980000)/,198,222,0,0,82,84,0,2022-01-30 18:23:00
4408.5,188,262,4410.5,4408.25,4410.5,13,/Date(1643585040000)/,296,388,0,0,108,126,0,2022-01-30 18:24:00
4411.0,116,173,4411.5,4408.0,4408.75,13,/Date(1643585100000)/,280,365,0,0,164,192,0,2022-01-30 18:25:00
4410.25,140,171,4412.25,4410.25,4411.0,13,/Date(1643585160000)/,269,310,0,0,129,139,0,2022-01-30 18:26:00
4412.25,68,73,4412.25,4409.5,4410.5,13,/Date(1643585220000)/,143,153,0,0,75,80,0,2022-01-30 18:27:00
4412.0,62,75,4412.25,4411.25,4412.25,13,/Date(1643585280000)/,119,134,0,0,57,59,0,2022-01-30 18:28:00
4413.25,85,98,4413.5,4411.75,4412.0,13,/Date(1643585340000)/,247,301,0,0,162,203,0,2022-01-30 18:29:00
4415.25,115,123,4415.5,4412.75,4413.25,13,/Date(1643585400000)/,282,320,0,0,167,197,0,2022-01-30 18:30:00
4415.0,185,247,4416.0,4414.25,4415.25,13,/Date(1643585460000)/,342,438,0,0,157,191,0,2022-01-30 18:31:00
4413.75,120,130,4415.5,4413.25,4415.0,13,/Date(1643585520000)/,201,213,0,0,81,83,0,2022-01-30 18:32:00
4411.25,164,200,4414.0,4411.25,4413.5,13,/Date(1643585580000)/,234,280,0,0,70,80,0,2022-01-30 18:33:00
4413.25,53,63,4413.5,4411.5,4411.5,13,/Date(1643585640000)/,142,169,0,0,89,106,0,2022-01-30 18:34:00
4412.5,106,134,4414.25,4412.0,4413.25,13,/Date(1643585700000)/,208,238,0,0,102,104,0,2022-01-30 18:35:00
4409.0,299,451,4412.75,4407.25,4412.75,13,/Date(1643585760000)/,469,633,0,0,170,182,0,2022-01-30 18:36:00
4410.0,90,102,4411.0,4408.75,4408.75,13,/Date(1643585820000)/,213,238,0,0,123,136,0,2022-01-30 18:37:00
4409.0,116,132,4411.0,4408.0,4410.0,13,/Date(1643585880000)/,207,234,0,0,91,102,0,2022-01-30 18:38:00
4410.0,73,88,4410.75,4409.25,4409.25,13,/Date(1643585940000)/,171,193,0,0,98,105,0,2022-01-30 18:39:00
4408.0,149,175,4410.25,4407.75,4410.0,13,/Date(1643586000000)/,222,252,0,0,73,77,0,2022-01-30 18:40:00
4409.25,132,176,4410.25,4407.75,4408.0,13,/Date(1643586060000)/,310,381,0,0,178,205,0,2022-01-30 18:41:00
4411.5,126,160,4412.25,4408.25,4409.0,13,/Date(1643586120000)/,315,413,0,0,189,253,0,2022-01-30 18:42:00
4410.5,125,142,4412.5,4410.25,4411.5,13,/Date(1643586180000)/,211,241,0,0,86,99,0,2022-01-30 18:43:00
4410.0,67,97,4411.25,4409.5,4410.5,13,/Date(1643586240000)/,124,171,0,0,57,74,0,2022-01-30 18:44:00
4407.5,175,223,4409.75,4407.25,4409.5,13,/Date(1643586300000)/,279,334,0,0,104,111,0,2022-01-30 18:45:00
4403.5,504,628,4407.5,4402.75,4407.5,13,/Date(1643586360000)/,917,1098,0,0,413,470,0,2022-01-30 18:46:00
4405.0,115,151,4405.25,4403.25,4403.25,13,/Date(1643586420000)/,292,386,0,0,177,235,0,2022-01-30 18:47:00
4406.5,73,74,4406.5,4404.0,4405.25,13,/Date(1643586480000)/,206,226,0,0,133,152,0,2022-01-30 18:48:00
4405.25,88,103,4406.25,4404.75,4406.25,13,/Date(1643586540000)/,161,192,0,0,73,89,0,2022-01-30 18:49:00
4406.0,50,54,4406.25,4404.75,4405.0,13,/Date(1643586600000)/,118,131,0,0,68,77,0,2022-01-30 18:50:00
4406.25,51,57,4406.5,4405.5,4405.75,13,/Date(1643586660000)/,111,125,0,0,60,68,0,2022-01-30 18:51:00
4408.25,49,54,4408.75,4406.25,4406.25,13,/Date(1643586720000)/,187,214,0,0,138,160,0,2022-01-30 18:52:00
4409.75,84,94,4409.75,4408.0,4408.5,13,/Date(1643586780000)/,201,224,0,0,117,130,0,2022-01-30 18:53:00
4409.5,96,103,4410.5,4408.75,4410.0,13,/Date(1643586840000)/,197,213,0,0,101,110,0,2022-01-30 18:54:00
4409.25,90,109,4410.0,4408.0,4409.75,13,/Date(1643586900000)/,163,188,0,0,73,79,0,2022-01-30 18:55:00
4408.5,40,40,4409.5,4408.0,4409.25,13,/Date(1643586960000)/,67,68,0,0,27,28,0,2022-01-30 18:56:00
4408.75,26,31,4409.0,4408.25,4408.75,13,/Date(1643587020000)/,59,65,0,0,33,34,0,2022-01-30 18:57:00
4409.5,44,52,4409.75,4407.75,4408.75,13,/Date(1643587080000)/,92,107,0,0,48,55,0,2022-01-30 18:58:00
4411.75,98,118,4412.25,4409.0,4409.5,13,/Date(1643587140000)/,286,335,0,0,188,217,0,2022-01-30 18:59:00
4412.5,130,189,4412.5,4410.75,4412.0,13,/Date(1643587200000)/,244,344,0,0,114,155,0,2022-01-30 19:00:00
4410.0,248,305,4413.0,4409.5,4412.5,13,/Date(1643587260000)/,470,553,0,0,222,248,0,2022-01-30 19:01:00
4407.5,147,165,4410.5,4407.5,4409.75,13,/Date(1643587320000)/,244,273,0,0,97,108,0,2022-01-30 19:02:00
4409.0,130,164,4409.0,4406.25,4407.5,13,/Date(1643587380000)/,272,328,0,0,142,164,0,2022-01-30 19:03:00
4410.0,84,110,4410.0,4407.75,4409.0,13,/Date(1643587440000)/,214,278,0,0,130,168,0,2022-01-30 19:04:00
4409.0,70,81,4410.0,4408.25,4410.0,13,/Date(1643587500000)/,107,140,0,0,37,59,0,2022-01-30 19:05:00
4408.0,86,99,4409.25,4407.0,4409.25,13,/Date(1643587560000)/,168,186,0,0,82,87,0,2022-01-30 19:06:00
4408.5,127,138,4410.75,4407.5,4407.75,13,/Date(1643587620000)/,219,249,0,0,92,111,0,2022-01-30 19:07:00
4406.0,232,278,4408.75,4405.25,4408.75,13,/Date(1643587680000)/,356,509,0,0,124,231,0,2022-01-30 19:08:00
4407.5,58,65,4408.0,4405.75,4406.25,13,/Date(1643587740000)/,146,158,0,0,88,93,0,2022-01-30 19:09:00
4407.0,105,121,4408.25,4405.25,4407.5,13,/Date(1643587800000)/,226,259,0,0,121,138,0,2022-01-30 19:10:00
4408.0,130,145,4409.75,4406.75,4406.75,13,/Date(1643587860000)/,235,262,0,0,105,117,0,2022-01-30 19:11:00
4409.75,72,81,4410.25,4408.25,4408.25,13,/Date(1643587920000)/,151,189,0,0,79,108,0,2022-01-30 19:12:00
4410.25,115,144,4410.75,4408.0,4409.75,13,/Date(1643587980000)/,232,315,0,0,117,171,0,2022-01-30 19:13:00
4411.0,108,146,4412.25,4410.25,4410.25,13,/Date(1643588040000)/,237,299,0,0,129,153,0,2022-01-30 19:14:00
4412.75,105,127,4413.25,4411.0,4411.0,13,/Date(1643588100000)/,303,385,0,0,198,258,0,2022-01-30 19:15:00
4415.25,216,311,4417.5,4412.0,4412.75,13,/Date(1643588160000)/,600,802,0,0,384,491,0,2022-01-30 19:16:00
4416.5,100,140,4416.75,4415.0,4415.5,13,/Date(1643588220000)/,233,286,0,0,133,146,0,2022-01-30 19:17:00
4416.25,78,107,4417.5,4415.5,4416.5,13,/Date(1643588280000)/,171,207,0,0,93,100,0,2022-01-30 19:18:00
4415.25,81,97,4417.25,4415.0,4416.5,13,/Date(1643588340000)/,163,181,0,0,82,84,0,2022-01-30 19:19:00
4414.0,137,174,4416.0,4414.0,4415.5,13,/Date(1643588400000)/,227,273,0,0,90,99,0,2022-01-30 19:20:00
4414.75,68,95,4415.5,4413.75,4414.25,13,/Date(1643588460000)/,130,163,0,0,62,68,0,2022-01-30 19:21:00
4416.0,97,129,4417.0,4414.0,4414.75,13,/Date(1643588520000)/,203,240,0,0,106,111,0,2022-01-30 19:22:00
4414.0,135,178,4416.25,4414.0,4415.75,13,/Date(1643588580000)/,184,228,0,0,49,50,0,2022-01-30 19:23:00
4411.5,196,267,4414.5,4411.25,4414.25,13,/Date(1643588640000)/,311,386,0,0,115,119,0,2022-01-30 19:24:00
4409.25,267,347,4412.5,4408.75,4411.75,13,/Date(1643588700000)/,465,585,0,0,198,238,0,2022-01-30 19:25:00
4410.75,42,50,4411.0,4409.5,4409.5,13,/Date(1643588760000)/,105,124,0,0,63,74,0,2022-01-30 19:26:00
4412.25,88,121,4412.25,4410.25,4410.75,13,/Date(1643588820000)/,206,260,0,0,118,139,0,2022-01-30 19:27:00
4412.5,104,124,4413.0,4411.25,4412.5,13,/Date(1643588880000)/,186,227,0,0,82,103,0,2022-01-30 19:28:00
4414.25,70,99,4414.75,4411.75,4412.25,13,/Date(1643588940000)/,167,224,0,0,97,125,0,2022-01-30 19:29:00
4416.5,60,62,4416.5,4414.0,4414.25,13,/Date(1643589000000)/,180,211,0,0,120,149,0,2022-01-30 19:30:00
4414.75,149,183,4416.75,4414.25,4416.5,13,/Date(1643589060000)/,233,274,0,0,84,91,0,2022-01-30 19:31:00
4415.25,73,77,4415.5,4414.25,4414.5,13,/Date(1643589120000)/,144,198,0,0,71,121,0,2022-01-30 19:32:00
4415.25,97,110,4417.5,4414.5,4415.0,13,/Date(1643589180000)/,205,241,0,0,108,131,0,2022-01-30 19:33:00
4416.25,58,68,4416.75,4415.25,4415.5,13,/Date(1643589240000)/,129,163,0,0,71,95,0,2022-01-30 19:34:00
4417.0,48,56,4417.25,4415.5,4416.5,13,/Date(1643589300000)/,102,113,0,0,54,57,0,2022-01-30 19:35:00
4420.5,149,192,4420.5,4416.75,4416.75,13,/Date(1643589360000)/,551,729,0,0,402,537,0,2022-01-30 19:36:00
4418.75,129,210,4420.75,4418.25,4420.5,13,/Date(1643589420000)/,231,332,0,0,102,122,0,2022-01-30 19:37:00
4418.0,70,77,4419.0,4417.75,4418.75,13,/Date(1643589480000)/,146,156,0,0,76,79,0,2022-01-30 19:38:00
4417.75,90,121,4418.5,4417.25,4418.25,13,/Date(1643589540000)/,161,209,0,0,71,88,0,2022-01-30 19:39:00
4415.5,172,197,4419.25,4415.25,4418.0,13,/Date(1643589600000)/,310,354,0,0,138,157,0,2022-01-30 19:40:00
4415.25,150,191,4415.5,4414.25,4415.5,13,/Date(1643589660000)/,263,328,0,0,113,137,0,2022-01-30 19:41:00
4414.25,95,128,4415.75,4413.75,4415.25,13,/Date(1643589720000)/,112,146,0,0,17,18,0,2022-01-30 19:42:00
4413.25,153,181,4415.25,4411.75,4414.0,13,/Date(1643589780000)/,240,280,0,0,87,99,0,2022-01-30 19:43:00
4414.0,74,94,4414.25,4412.75,4413.25,13,/Date(1643589840000)/,140,181,0,0,66,87,0,2022-01-30 19:44:00
4413.75,37,39,4414.5,4413.25,4413.75,13,/Date(1643589900000)/,67,74,0,0,30,35,0,2022-01-30 19:45:00
4414.5,69,71,4415.5,4413.75,4414.0,13,/Date(1643589960000)/,145,176,0,0,76,105,0,2022-01-30 19:46:00
4414.5,92,96,4415.0,4413.25,4414.5,13,/Date(1643590020000)/,147,155,0,0,55,59,0,2022-01-30 19:47:00
4413.25,50,58,4414.5,4413.0,4414.5,13,/Date(1643590080000)/,58,66,0,0,8,8,0,2022-01-30 19:48:00
4414.5,13,14,4414.5,4413.25,4413.5,13,/Date(1643590140000)/,38,40,0,0,25,26,0,2022-01-30 19:49:00
4413.25,53,64,4414.5,4413.0,4414.5,13,/Date(1643590200000)/,80,92,0,0,27,28,0,2022-01-30 19:50:00
4411.5,150,159,4413.75,4410.75,4413.25,13,/Date(1643590260000)/,259,279,0,0,109,120,0,2022-01-30 19:51:00
4412.5,48,54,4413.0,4411.5,4411.5,13,/Date(1643590320000)/,101,114,0,0,53,60,0,2022-01-30 19:52:00
4413.5,64,67,4414.25,4412.75,4412.75,13,/Date(1643590380000)/,118,126,0,0,54,59,0,2022-01-30 19:53:00
4414.5,54,60,4415.0,4413.5,4413.5,13,/Date(1643590440000)/,151,175,0,0,97,115,0,2022-01-30 19:54:00
4412.75,62,73,4414.75,4412.75,4414.5,13,/Date(1643590500000)/,106,120,0,0,44,47,0,2022-01-30 19:55:00
4413.0,22,28,4413.5,4412.5,4412.5,13,/Date(1643590560000)/,48,58,0,0,26,30,0,2022-01-30 19:56:00
4411.75,82,97,4414.0,4411.25,4413.25,13,/Date(1643590620000)/,136,156,0,0,54,59,0,2022-01-30 19:57:00
4411.75,71,86,4411.75,4410.75,4411.25,13,/Date(1643590680000)/,141,159,0,0,70,73,0,2022-01-30 19:58:00
4411.75,103,115,4413.25,4411.5,4411.5,13,/Date(1643590740000)/,217,243,0,0,114,128,0,2022-01-30 19:59:00
4409.5,215,308,4412.0,4409.0,4412.0,13,/Date(1643590800000)/,312,412,0,0,97,104,0,2022-01-30 20:00:00
4412.0,90,96,4412.75,4409.0,4409.75,13,/Date(1643590860000)/,236,267,0,0,146,171,0,2022-01-30 20:01:00
4413.5,126,140,4415.0,4410.75,4412.0,13,/Date(1643590920000)/,302,357,0,0,176,217,0,2022-01-30 20:02:00
4414.0,116,130,4414.75,4412.5,4413.25,13,/Date(1643590980000)/,305,367,0,0,189,237,0,2022-01-30 20:03:00
4414.0,42,45,4414.5,4413.0,4413.75,13,/Date(1643591040000)/,112,127,0,0,70,82,0,2022-01-30 20:04:00
4412.5,89,96,4414.0,4412.0,4414.0,13,/Date(1643591100000)/,125,133,0,0,36,37,0,2022-01-30 20:05:00
4413.5,72,75,4414.5,4412.0,4412.25,13,/Date(1643591160000)/,147,158,0,0,75,83,0,2022-01-30 20:06:00
4411.0,93,109,4413.25,4411.0,4413.25,13,/Date(1643591220000)/,159,178,0,0,66,69,0,2022-01-30 20:07:00
4412.75,54,65,4413.5,4410.75,4411.0,536870917,/Date(1643591280000)/,116,140,0,0,62,75,0,2022-01-30 20:08:00
